project,case_id,method,prompt_type,status,true_positives,false_positives,true_negatives,false_negatives,success_count,failure_count,prompt_tokens,completion_tokens,total_tokens,query_count
llama_index,pair_3,LogPrompt,CoT,success,2,1,8,1,12,0,12411,7904,20315,12
ColossalAI,pair_3,LogPrompt,InContext,success,387,5,23,62,477,0,1399932,464283,1864215,477
julia,pair_2,LogPrompt,InContext,success,1,1,4,0,6,0,6279,2863,9142,6
godot,pair_4,LogPrompt,InContext,success,0,0,8,2,10,0,13512,5416,18928,10
htmx,pair_1,LogPrompt,CoT,success,1,0,4,2,7,0,12771,3879,16650,7
ollama,pair_1,LogPrompt,CoT,success,1,0,4,1,6,0,6362,4035,10397,6
terminal,pair_4,LogPrompt,CoT,success,1,0,2,0,3,0,994,693,1687,3
LLMs-from-scratch,pair_2,LogPrompt,InContext,success,1,2,6,0,9,0,13935,6567,20502,9
mongoose,pair_3,LogPrompt,InContext,success,0,1,3,3,7,0,17461,4081,21542,7
cypress,pair_2,LogPrompt,InContext,success,1,0,5,0,6,0,6486,3166,9652,6
pixijs,pair_2,LogPrompt,InContext,success,0,0,4,1,5,0,29752,3393,33145,5
ColossalAI,pair_1,LogPrompt,InContext,success,1,1,9,0,11,0,24125,9143,33268,11
prettier,pair_2,LogPrompt,CoT,success,1,0,8,0,9,0,6214,4537,10751,9
hugo,pair_4,LogPrompt,CoT,success,6,0,34,2,42,0,75344,31791,107135,42
grafana,pair_3,LogPrompt,InContext,success,3,1,5,0,9,0,24265,7429,31694,9
gpt_academic,pair_3,LogPrompt,InContext,success,2,7,9,5,23,0,116237,18386,134623,23
nvm,pair_1,LogPrompt,InContext,success,1,1,4,0,6,0,8078,2976,11054,6
neovim,pair_1,LogPrompt,InContext,success,1,8,53,2,64,1,205177,58853,264030,64
youtube-dl,pair_1,LogPrompt,InContext,success,1,2,8,0,11,0,18341,7294,25635,11
n8n,pair_1,LogPrompt,CoT,success,2,9,131,6,148,0,314205,135634,449839,148
fabric,pair_1,LogPrompt,CoT,success,1,0,4,33,38,0,148526,34719,183245,38
laravel,pair_2,LogPrompt,InContext,success,1,3,10,0,14,0,21567,8866,30433,14
tailwindcss,pair_2,LogPrompt,InContext,success,3,6,18,0,27,1,50503,20563,71066,27
pixijs,pair_4,LogPrompt,CoT,success,1,0,6,0,7,0,5025,3740,8765,7
bubbletea,pair_1,LogPrompt,InContext,success,1,2,7,0,10,0,14079,6258,20337,10
dubbo,pair_4,LogPrompt,InContext,success,10,3,7,120,140,0,425896,136378,562274,140
pandas,pair_1,LogPrompt,InContext,success,5,5,29,0,39,0,136988,33907,170895,39
spring-boot,pair_3,LogPrompt,InContext,success,6,2,6,5,19,0,47528,16131,63659,19
ionic-framework,pair_2,LogPrompt,InContext,success,4,1,4,2,11,0,23072,8443,31515,11
pixijs,pair_4,LogPrompt,InContext,success,1,1,5,0,7,0,8098,4146,12244,7
fzf,pair_1,LogPrompt,CoT,success,1,1,10,0,12,0,12227,8371,20598,12
laravel,pair_4,LogPrompt,InContext,success,1,2,11,0,14,0,22038,8984,31022,14
AutoGPT,pair_2,LogPrompt,CoT,success,1,0,6,0,7,0,5014,3563,8577,7
dify,pair_1,LogPrompt,CoT,success,1,0,6,0,7,0,4097,3108,7205,7
neovim,pair_1,LogPrompt,CoT,success,1,2,59,2,64,1,173338,56305,229643,64
hugo,pair_3,LogPrompt,InContext,success,7,9,25,1,42,0,96639,36141,132780,42
terminal,pair_4,LogPrompt,InContext,success,1,0,2,0,3,0,2505,923,3428,3
gpt4all,pair_4,LogPrompt,InContext,success,1,1,4,0,6,0,9363,3860,13223,6
playwright,pair_1,LogPrompt,InContext,success,3,0,5,15,23,0,81947,20322,102269,23
starship,pair_1,LogPrompt,CoT,success,1,2,4,0,7,0,4754,3607,8361,7
ColossalAI,pair_1,LogPrompt,CoT,success,1,0,10,0,11,0,18859,8790,27649,11
ionic-framework,pair_4,LogPrompt,InContext,success,3,0,5,29,37,0,95585,34435,130020,37
mongoose,pair_2,LogPrompt,CoT,success,3,1,6,45,55,0,157202,49163,206365,55
AutoGPT,pair_2,LogPrompt,InContext,success,1,1,5,0,7,0,8377,3949,12326,7
godot,pair_1,LogPrompt,InContext,success,1,15,63,0,79,0,527003,72646,599649,79
ui,pair_1,LogPrompt,CoT,success,1,0,4,2,7,0,14373,3940,18313,7
django,pair_1,LogPrompt,CoT,success,7,0,9,18,34,0,56776,30835,87611,34
stable-diffusion-webui,pair_4,LogPrompt,InContext,success,0,1,5,1,7,0,8159,4064,12223,7
open-webui,pair_4,LogPrompt,CoT,success,1,0,5,0,6,0,4603,3689,8292,6
okhttp,pair_1,LogPrompt,InContext,success,7,5,9,6,27,0,66579,21413,87992,27
PowerShell,pair_3,LogPrompt,InContext,success,1,0,4,1,6,0,8377,3873,12250,6
styled-components,pair_1,LogPrompt,InContext,success,1,2,4,0,7,0,8380,4028,12408,7
grafana,pair_4,LogPrompt,InContext,success,94,1,5,0,100,0,340456,98374,438830,100
htmx,pair_2,LogPrompt,InContext,success,1,1,5,0,7,0,7685,4231,11916,7
terraform,pair_3,LogPrompt,InContext,success,1,1,4,1,7,0,8387,4334,12721,7
generative-ai-for-beginners,pair_1,LogPrompt,CoT,success,0,0,4,3,7,0,14085,3863,17948,7
bruno,pair_1,LogPrompt,CoT,success,1,3,11,0,15,0,12804,8639,21443,15
ColossalAI,pair_2,LogPrompt,InContext,success,366,4,23,82,475,0,1396335,461694,1858029,475
gpt_academic,pair_4,LogPrompt,InContext,success,4,5,10,2,21,1,67499,16941,84440,21
cpython,pair_2,LogPrompt,InContext,success,0,0,6,3,9,0,15130,5897,21027,9
generative-ai-for-beginners,pair_2,LogPrompt,InContext,success,1,1,3,2,7,0,17160,4111,21271,7
retrofit,pair_2,LogPrompt,CoT,success,1,0,9,3,13,0,17838,7194,25032,13
playwright,pair_4,LogPrompt,CoT,success,1,0,5,3,9,0,11369,5762,17131,9
nvm,pair_1,LogPrompt,CoT,success,1,2,3,0,6,0,5121,2676,7797,6
retrofit,pair_4,LogPrompt,InContext,success,6,2,8,105,121,0,303436,117374,420810,121
julia,pair_4,LogPrompt,InContext,success,1,2,1,0,4,0,6453,1917,8370,4
AutoGPT,pair_1,LogPrompt,CoT,success,0,0,6,0,6,4,4301,3142,7443,6
terminal,pair_2,LogPrompt,CoT,success,1,0,2,0,3,0,994,820,1814,3
ionic-framework,pair_4,LogPrompt,CoT,success,2,0,5,30,37,0,78985,34157,113142,37
markitdown,pair_2,LogPrompt,CoT,success,2,0,6,1,9,0,12393,5965,18358,9
llama_index,pair_4,LogPrompt,InContext,success,0,4,12,1,17,0,32088,13281,45369,17
laravel,pair_1,LogPrompt,InContext,success,1,2,11,0,14,0,21919,9655,31574,14
open-webui,pair_3,LogPrompt,CoT,success,1,0,7,46,54,0,148705,49452,198157,54
slate,pair_4,LogPrompt,CoT,success,1,0,5,1,7,0,8414,3983,12397,7
cypress,pair_4,LogPrompt,CoT,success,1,0,5,0,6,0,3579,2631,6210,6
fuels-ts,pair_3,LogPrompt,CoT,success,8,10,32,10,60,0,233177,54596,287773,60
okhttp,pair_2,LogPrompt,CoT,success,1,1,12,8,22,0,39297,15798,55095,22
duckdb,pair_2,LogPrompt,InContext,success,35,3,8,98,144,0,1449688,140859,1590547,144
uv,pair_1,LogPrompt,InContext,success,4,0,13,22,39,0,201309,35803,237112,39
markitdown,pair_1,LogPrompt,InContext,success,3,1,5,0,9,0,17085,6068,23153,9
meilisearch,pair_3,LogPrompt,InContext,success,4,5,13,13,35,0,95678,31330,127008,35
julia,pair_2,LogPrompt,CoT,success,1,0,5,0,6,0,3655,2430,6085,6
supabase,pair_4,LogPrompt,CoT,success,0,0,15,1,16,0,32046,13403,45449,16
mongoose,pair_4,LogPrompt,CoT,success,1,0,6,0,7,0,4804,3623,8427,7
terraform,pair_1,LogPrompt,InContext,success,1,0,6,3,10,0,22551,7408,29959,10
terminal,pair_1,LogPrompt,InContext,success,1,0,2,0,3,0,2163,965,3128,3
n8n,pair_2,LogPrompt,CoT,success,1,3,18,2,24,0,84669,16746,101415,24
django,pair_4,LogPrompt,CoT,success,1,0,7,0,8,0,8688,4048,12736,8
netdata,pair_4,LogPrompt,CoT,success,5,0,10,11,26,0,76777,23899,100676,26
certbot,pair_3,LogPrompt,InContext,success,1,0,3,0,4,0,5302,2822,8124,4
vault,pair_3,LogPrompt,CoT,success,1,0,2,0,3,0,1053,850,1903,3
markitdown,pair_3,LogPrompt,InContext,success,1,2,4,0,7,0,8808,4285,13093,7
code-server,pair_2,LogPrompt,InContext,success,1,1,12,0,14,0,23347,10806,34153,14
supabase,pair_2,LogPrompt,InContext,success,1,3,12,0,16,0,39462,12965,52427,16
fabric,pair_3,LogPrompt,InContext,success,1,1,5,0,7,0,9846,3701,13547,7
terminal,pair_1,LogPrompt,CoT,success,1,0,2,0,3,0,994,827,1821,3
htmx,pair_2,LogPrompt,CoT,success,1,0,6,0,7,0,4521,3695,8216,7
cypress,pair_4,LogPrompt,InContext,success,1,1,4,0,6,0,6054,3542,9596,6
ink-kit,pair_2,LogPrompt,InContext,success,1,2,6,0,9,0,12279,5722,18001,9
hugo,pair_2,LogPrompt,InContext,success,3,2,64,2,71,0,183143,68025,251168,71
prettier,pair_4,LogPrompt,CoT,success,1,0,23,0,24,0,17298,10823,28121,24
ui,pair_2,LogPrompt,CoT,success,0,0,4,29,33,0,127494,29899,157393,33
flask,pair_4,LogPrompt,InContext,success,11,1,7,37,56,1,131234,51922,183156,56
bubbletea,pair_3,LogPrompt,InContext,success,1,0,4,1,6,0,10019,3061,13080,6
cockroach,pair_1,LogPrompt,InContext,success,1,4,9,2,16,0,29309,9499,38808,16
nvm,pair_3,LogPrompt,InContext,success,1,1,4,0,6,0,7823,3271,11094,6
AutoGPT,pair_1,LogPrompt,InContext,success,0,2,4,0,6,4,6921,3492,10413,6
fabric,pair_2,LogPrompt,CoT,success,0,1,11,2,14,0,24610,10752,35362,14
cpython,pair_4,LogPrompt,InContext,success,1,43,103,1,148,0,556040,141443,697483,148
starship,pair_3,LogPrompt,CoT,success,1,2,4,0,7,0,4748,3595,8343,7
LLMs-from-scratch,pair_2,LogPrompt,CoT,success,1,0,8,0,9,0,9875,5942,15817,9
prettier,pair_4,LogPrompt,InContext,success,1,6,17,0,24,0,28015,13945,41960,24
vault,pair_2,LogPrompt,InContext,success,1,0,2,0,3,0,2369,1295,3664,3
certbot,pair_2,LogPrompt,CoT,success,1,0,2,0,3,0,1101,967,2068,3
docling,pair_1,LogPrompt,CoT,success,1,0,12,0,13,0,13717,6612,20329,13
ColossalAI,pair_4,LogPrompt,InContext,success,3,4,23,0,30,0,109864,23266,133130,30
alpine,pair_2,LogPrompt,InContext,success,9,1,9,0,19,0,47184,16135,63319,19
fabric,pair_2,LogPrompt,InContext,success,0,2,10,2,14,0,30929,11618,42547,14
markitdown,pair_4,LogPrompt,CoT,success,10,0,6,3,19,0,32392,13870,46262,19
markitdown,pair_2,LogPrompt,InContext,success,3,2,4,0,9,0,16253,6384,22637,9
spring-boot,pair_1,LogPrompt,CoT,success,1,1,13,0,15,0,15666,8830,24496,15
fuels-ts,pair_1,LogPrompt,InContext,success,1,19,26,0,46,0,192764,41358,234122,46
wtfpython,pair_4,LogPrompt,InContext,success,1,0,5,0,6,0,7071,3088,10159,6
netdata,pair_2,LogPrompt,CoT,success,3,1,18,20,42,0,121496,39211,160707,42
vault,pair_2,LogPrompt,CoT,success,1,0,2,0,3,0,1053,850,1903,3
AdminLTE,pair_1,LogPrompt,InContext,success,1,0,4,2,7,0,25671,4116,29787,7
elasticsearch,pair_2,LogPrompt,InContext,success,1,0,9,0,10,0,21532,7631,29163,10
lx-music-desktop,pair_1,LogPrompt,CoT,success,1,0,10,0,11,0,10899,5845,16744,11
pandas,pair_2,LogPrompt,CoT,success,4,0,19,0,23,0,59422,18929,78351,23
stable-diffusion-webui,pair_1,LogPrompt,CoT,success,1,0,6,0,7,0,4298,3126,7424,7
stable-diffusion-webui,pair_3,LogPrompt,CoT,success,1,0,6,0,7,0,4295,3169,7464,7
dify,pair_3,LogPrompt,CoT,success,1,2,16,5,24,0,31244,16630,47874,24
ink-kit,pair_3,LogPrompt,CoT,success,1,0,6,0,7,0,5051,3570,8621,7
cypress,pair_3,LogPrompt,CoT,success,1,0,5,0,6,0,3582,2907,6489,6
fzf,pair_1,LogPrompt,InContext,success,1,2,9,0,12,0,18190,9878,28068,12
uv,pair_2,LogPrompt,CoT,success,2,0,12,23,37,0,179459,32195,211654,37
elasticsearch,pair_1,LogPrompt,InContext,success,1,0,9,0,10,0,22288,7503,29791,10
llama_index,pair_1,LogPrompt,InContext,success,0,4,12,1,17,0,32282,12165,44447,17
terraform,pair_1,LogPrompt,CoT,success,1,0,6,3,10,0,17702,6514,24216,10
netdata,pair_3,LogPrompt,InContext,success,3,8,24,40,75,0,498829,72375,571204,75
llama_index,pair_1,LogPrompt,CoT,success,0,0,16,1,17,0,24600,12033,36633,17
commander.js,pair_1,LogPrompt,CoT,success,1,2,6,0,9,0,7231,5047,12278,9
spark,pair_1,LogPrompt,CoT,success,1,0,2,0,3,0,1389,1460,2849,3
playwright,pair_3,LogPrompt,InContext,success,0,4,5,3,12,0,22475,9020,31495,12
Ghost,pair_1,LogPrompt,CoT,success,14,0,12,13,39,0,161786,32218,194004,39
dify,pair_2,LogPrompt,CoT,success,2,1,15,3,21,0,26823,15243,42066,21
generative-ai-for-beginners,pair_4,LogPrompt,InContext,success,2,0,4,2,8,0,19887,4720,24607,8
slate,pair_1,LogPrompt,CoT,success,0,1,28,18,47,0,83725,43869,127594,47
grafana,pair_4,LogPrompt,CoT,success,88,0,6,6,100,0,295386,73460,368846,100
duckdb,pair_1,LogPrompt,CoT,success,12,2,118,257,389,0,1823119,383295,2206414,389
jan,pair_2,LogPrompt,CoT,success,4,0,19,4,27,0,52366,21098,73464,27
grafana,pair_1,LogPrompt,CoT,success,1,0,7,1,9,0,9903,3818,13721,9
tailwindcss,pair_2,LogPrompt,CoT,success,0,2,23,3,28,0,38817,19444,58261,28
wtfpython,pair_1,LogPrompt,CoT,success,12,0,5,0,17,0,95336,14315,109651,17
docling,pair_1,LogPrompt,InContext,success,1,2,10,0,13,0,20085,7486,27571,13
stable-diffusion-webui,pair_4,LogPrompt,CoT,success,1,0,6,0,7,0,4564,3280,7844,7
nvm,pair_4,LogPrompt,InContext,success,1,1,7,0,9,0,15555,6198,21753,9
Ghost,pair_1,LogPrompt,InContext,success,16,2,10,11,39,0,180408,36276,216684,39
supabase,pair_1,LogPrompt,CoT,success,1,0,10,0,11,0,11587,5967,17554,11
cockroach,pair_3,LogPrompt,InContext,success,1,0,2,0,3,0,3036,1674,4710,3
godot,pair_3,LogPrompt,InContext,success,2,2,6,1,11,0,17523,6413,23936,11
stats,pair_1,LogPrompt,CoT,success,1,0,9,0,10,0,14059,6687,20746,10
okhttp,pair_3,LogPrompt,InContext,success,2,1,13,5,21,0,43966,16367,60333,21
ollama,pair_1,LogPrompt,InContext,success,0,0,4,2,6,0,8885,4260,13145,6
retrofit,pair_1,LogPrompt,InContext,success,0,4,5,1,10,0,16373,6771,23144,10
gpt4all,pair_3,LogPrompt,InContext,success,1,0,5,0,6,0,9787,3566,13353,6
open-webui,pair_2,LogPrompt,InContext,success,1,1,6,0,8,0,9504,4888,14392,8
mongoose,pair_3,LogPrompt,CoT,success,0,0,4,3,7,0,14334,3932,18266,7
gpt_academic,pair_1,LogPrompt,InContext,success,3,5,10,5,23,1,124560,17858,142418,23
retrofit,pair_4,LogPrompt,CoT,success,3,0,10,107,120,1,245973,114838,360811,120
AdminLTE,pair_2,LogPrompt,InContext,success,2,1,5,0,8,0,12492,5444,17936,8
uv,pair_1,LogPrompt,CoT,success,1,0,13,25,39,0,183022,33756,216778,39
gpt4all,pair_4,LogPrompt,CoT,success,1,0,5,0,6,0,6531,3361,9892,6
prettier,pair_3,LogPrompt,CoT,success,136,1,6,48,191,0,395624,170967,566591,191
youtube-dl,pair_2,LogPrompt,InContext,success,1,4,12,3,20,0,41156,16554,57710,20
llama_index,pair_4,LogPrompt,CoT,success,0,0,16,1,17,0,24593,12525,37118,17
fabric,pair_1,LogPrompt,InContext,success,4,0,4,30,38,0,165872,35128,201000,38
cpython,pair_3,LogPrompt,CoT,success,1,0,6,2,9,0,10505,5289,15794,9
stats,pair_4,LogPrompt,InContext,success,1,1,8,0,10,0,18170,7174,25344,10
cypress,pair_1,LogPrompt,CoT,success,1,0,5,0,6,0,3582,2807,6389,6
retrofit,pair_1,LogPrompt,CoT,success,0,0,9,1,10,0,11998,6267,18265,10
commander.js,pair_2,LogPrompt,InContext,success,1,1,4,0,6,0,6519,3674,10193,6
gpt4all,pair_1,LogPrompt,InContext,success,1,0,5,0,6,0,9332,3674,13006,6
terraform,pair_3,LogPrompt,CoT,success,2,1,4,0,7,0,5163,3995,9158,7
vllm,pair_2,LogPrompt,InContext,success,3,11,64,0,78,0,396955,72954,469909,78
dify,pair_1,LogPrompt,InContext,success,0,1,5,1,7,0,7310,3795,11105,7
pandas,pair_3,LogPrompt,InContext,success,1,11,43,0,55,0,150971,47873,198844,55
pandas,pair_4,LogPrompt,CoT,failed,0,0,0,0,0,0,0,0,0,0
bubbletea,pair_4,LogPrompt,CoT,success,1,90,14,0,105,0,689977,102626,792603,105
julia,pair_3,LogPrompt,InContext,success,0,0,4,1,5,0,6950,3393,10343,5
julia,pair_3,LogPrompt,CoT,success,0,0,4,1,5,0,4684,2822,7506,5
starship,pair_4,LogPrompt,InContext,success,1,1,5,0,7,0,8025,4527,12552,7
flask,pair_3,LogPrompt,InContext,success,31,1,8,56,96,1,664877,90729,755606,96
supabase,pair_3,LogPrompt,InContext,success,1,1,9,0,11,0,16742,6857,23599,11
playwright,pair_1,LogPrompt,CoT,success,1,0,5,17,23,0,71595,19204,90799,23
slate,pair_3,LogPrompt,InContext,success,1,0,5,1,7,0,11798,4919,16717,7
generative-ai-for-beginners,pair_3,LogPrompt,CoT,success,1,0,4,3,8,0,16912,4591,21503,8
duckdb,pair_4,LogPrompt,CoT,success,1,2,117,0,120,0,528727,115993,644720,120
dubbo,pair_1,LogPrompt,InContext,success,11,3,6,80,100,0,299047,96157,395204,100
netdata,pair_3,LogPrompt,CoT,success,4,1,31,39,75,0,463294,72464,535758,75
cpython,pair_1,LogPrompt,CoT,success,15,1,49,26,91,0,376700,80314,457014,91
lossless-cut,pair_1,LogPrompt,InContext,success,8,0,4,18,30,0,160375,27328,187703,30
insomnia,pair_1,LogPrompt,InContext,success,1,21,9,0,31,0,115203,27420,142623,31
open-webui,pair_1,LogPrompt,InContext,success,1,2,5,0,8,0,9999,4920,14919,8
playwright,pair_3,LogPrompt,CoT,success,0,0,9,3,12,0,17201,8583,25784,12
meilisearch,pair_2,LogPrompt,CoT,success,1,0,8,0,9,0,16447,6737,23184,9
dubbo,pair_4,LogPrompt,CoT,success,6,0,10,124,140,0,361487,135014,496501,140
RxJava,pair_1,LogPrompt,InContext,success,5,1,7,1,14,0,31125,9841,40966,14
uv,pair_2,LogPrompt,InContext,success,3,1,11,22,37,0,196624,34560,231184,37
elasticsearch,pair_3,LogPrompt,InContext,success,0,3,69,2,74,0,365598,67735,433333,74
django,pair_4,LogPrompt,InContext,success,1,2,5,0,8,0,12404,4378,16782,8
alpine,pair_1,LogPrompt,CoT,success,0,0,4,3,7,0,15126,3974,19100,7
dify,pair_3,LogPrompt,InContext,success,2,3,15,4,24,0,43410,19033,62443,24
cockroach,pair_1,LogPrompt,CoT,success,1,0,13,2,16,0,22008,8849,30857,16
dify,pair_2,LogPrompt,InContext,success,3,2,14,2,21,0,36651,16778,53429,21
meilisearch,pair_4,LogPrompt,InContext,success,2,5,13,24,44,0,117938,40345,158283,44
gpt_academic,pair_1,LogPrompt,CoT,success,4,2,14,4,24,0,115660,17786,133446,24
code-server,pair_1,LogPrompt,InContext,success,1,2,11,0,14,0,22721,10031,32752,14
PowerShell,pair_2,LogPrompt,InContext,success,2,1,3,0,6,0,7763,3749,11512,6
stable-diffusion-webui,pair_1,LogPrompt,InContext,success,1,2,4,0,7,0,7851,3762,11613,7
gpt4all,pair_2,LogPrompt,CoT,success,1,0,5,0,6,0,6435,3260,9695,6
ui,pair_1,LogPrompt,InContext,success,2,3,1,1,7,0,17608,4239,21847,7
flask,pair_1,LogPrompt,InContext,success,1,1,7,2,11,0,14721,5708,20429,11
django,pair_3,LogPrompt,InContext,success,0,0,4,1,5,0,6722,3173,9895,5
wtfpython,pair_2,LogPrompt,CoT,success,1,0,5,0,6,0,3649,2670,6319,6
PowerShell,pair_3,LogPrompt,CoT,success,2,0,4,0,6,0,5171,3048,8219,6
grafana,pair_1,LogPrompt,InContext,success,1,2,5,1,9,0,14161,4855,19016,9
certbot,pair_4,LogPrompt,InContext,success,1,1,2,0,4,0,5317,2832,8149,4
django,pair_2,LogPrompt,InContext,success,0,0,4,1,5,0,6872,3204,10076,5
slate,pair_1,LogPrompt,InContext,success,3,7,22,15,47,0,105947,42095,148042,47
commander.js,pair_3,LogPrompt,CoT,success,1,1,4,0,6,0,3851,2983,6834,6
spark,pair_2,LogPrompt,InContext,success,1,1,1,0,3,0,2844,1771,4615,3
code-server,pair_1,LogPrompt,CoT,success,1,1,12,0,14,0,16464,8851,25315,14
certbot,pair_1,LogPrompt,CoT,success,1,0,2,0,3,0,1102,967,2069,3
code-server,pair_3,LogPrompt,CoT,success,1,1,12,0,14,0,16684,9564,26248,14
ionic-framework,pair_2,LogPrompt,CoT,success,4,0,5,2,11,0,18033,6879,24912,11
n8n,pair_4,LogPrompt,CoT,success,9,0,13,37,59,0,110758,51473,162231,59
fuels-ts,pair_1,LogPrompt,CoT,success,1,14,31,0,46,0,171678,39475,211153,46
fabric,pair_4,LogPrompt,InContext,success,1,7,15,0,23,0,47266,15198,62464,23
prettier,pair_1,LogPrompt,InContext,success,0,1,6,1,8,0,9095,4798,13893,8
generative-ai-for-beginners,pair_4,LogPrompt,CoT,success,1,0,4,3,8,0,16209,4394,20603,8
supabase,pair_3,LogPrompt,CoT,success,1,0,10,0,11,0,11488,5628,17116,11
flask,pair_4,LogPrompt,CoT,success,2,0,8,46,56,1,104559,51472,156031,56
mongoose,pair_1,LogPrompt,CoT,success,2,1,8,46,57,0,157939,51697,209636,57
godot,pair_3,LogPrompt,CoT,success,0,0,8,3,11,0,12356,6105,18461,11
duckdb,pair_3,LogPrompt,InContext,success,1,3,7,0,11,0,16754,8272,25026,11
stats,pair_3,LogPrompt,InContext,success,1,0,9,0,10,0,18652,6959,25611,10
styled-components,pair_1,LogPrompt,CoT,success,1,1,5,0,7,0,5051,3405,8456,7
lossless-cut,pair_1,LogPrompt,CoT,success,1,0,4,25,30,0,147150,26746,173896,30
htmx,pair_1,LogPrompt,InContext,success,1,1,3,2,7,0,16031,4244,20275,7
supabase,pair_2,LogPrompt,CoT,success,0,0,15,1,16,0,32073,13138,45211,16
pixijs,pair_1,LogPrompt,CoT,success,1,0,6,1,8,0,7110,4582,11692,8
spark,pair_4,LogPrompt,InContext,success,1,0,2,0,3,0,2675,1756,4431,3
generative-ai-for-beginners,pair_2,LogPrompt,CoT,success,0,0,4,3,7,0,13940,3801,17741,7
gpt_academic,pair_2,LogPrompt,InContext,success,2,6,10,4,22,0,68409,17582,85991,22
gpt_academic,pair_4,LogPrompt,CoT,success,1,2,13,4,20,2,44940,15127,60067,20
markitdown,pair_4,LogPrompt,InContext,success,9,0,6,4,19,0,41165,15747,56912,19
meilisearch,pair_1,LogPrompt,CoT,success,1,0,8,0,9,0,13867,6669,20536,9
okhttp,pair_2,LogPrompt,InContext,success,7,6,7,2,22,0,49815,17158,66973,22
cpython,pair_3,LogPrompt,InContext,success,0,0,6,3,9,0,14568,6064,20632,9
jan,pair_3,LogPrompt,CoT,success,3,0,19,5,27,0,53174,22226,75400,27
gpt4all,pair_3,LogPrompt,CoT,success,1,0,5,0,6,0,6637,3437,10074,6
certbot,pair_1,LogPrompt,InContext,success,1,0,2,0,3,0,2456,1100,3556,3
llama_index,pair_3,LogPrompt,InContext,success,2,2,7,1,12,0,17855,8502,26357,12
starship,pair_4,LogPrompt,CoT,success,1,2,4,0,7,0,4747,3537,8284,7
tailwindcss,pair_1,LogPrompt,InContext,success,0,5,16,6,27,0,53307,20356,73663,27
julia,pair_4,LogPrompt,CoT,success,1,1,2,0,4,0,4283,1840,6123,4
laravel,pair_3,LogPrompt,InContext,success,1,3,10,0,14,0,21500,9087,30587,14
godot,pair_1,LogPrompt,CoT,success,1,8,70,0,79,0,490001,70957,560958,79
stats,pair_2,LogPrompt,CoT,success,1,0,9,0,10,0,13840,6506,20346,10
ink-kit,pair_3,LogPrompt,InContext,success,1,0,6,0,7,0,8393,3928,12321,7
vllm,pair_1,LogPrompt,InContext,success,2,3,6,14,25,0,53122,19142,72264,25
terminal,pair_3,LogPrompt,InContext,success,1,0,2,0,3,0,2551,1015,3566,3
grafana,pair_3,LogPrompt,CoT,success,3,0,6,0,9,0,20091,7026,27117,9
jan,pair_1,LogPrompt,CoT,success,4,0,19,4,27,0,52372,21657,74029,27
netdata,pair_4,LogPrompt,InContext,success,6,2,8,10,26,0,89543,24968,114511,26
dubbo,pair_1,LogPrompt,CoT,success,2,1,8,89,100,0,253819,95633,349452,100
flask,pair_3,LogPrompt,CoT,success,2,0,9,85,96,1,619603,90514,710117,96
cockroach,pair_2,LogPrompt,InContext,success,1,1,7,3,12,0,17997,6129,24126,12
meilisearch,pair_2,LogPrompt,InContext,success,1,2,6,0,9,0,20366,7062,27428,9
playwright,pair_2,LogPrompt,InContext,success,1,3,19,0,23,0,67714,20597,88311,23
jan,pair_2,LogPrompt,InContext,success,5,1,18,3,27,0,64753,22593,87346,27
insomnia,pair_2,LogPrompt,CoT,success,1,11,20,0,32,0,101942,23675,125617,32
lossless-cut,pair_4,LogPrompt,CoT,success,1,0,4,25,30,0,147218,26901,174119,30
pandas,pair_3,LogPrompt,CoT,success,1,1,53,0,55,0,125571,45040,170611,55
pandas,pair_4,LogPrompt,InContext,failed,0,0,0,0,0,0,0,0,0,0
starship,pair_2,LogPrompt,CoT,success,1,2,4,0,7,0,4758,3618,8376,7
AutoGPT,pair_3,LogPrompt,InContext,success,1,2,4,0,7,0,9865,4528,14393,7
vllm,pair_3,LogPrompt,InContext,success,1,1,8,9,19,0,30129,13912,44041,19
vault,pair_1,LogPrompt,InContext,success,1,4,32,0,37,0,101706,34621,136327,37
open-webui,pair_4,LogPrompt,InContext,success,1,2,3,0,6,0,7430,3906,11336,6
n8n,pair_3,LogPrompt,CoT,success,1,1,20,2,24,0,86196,18434,104630,24
cypress,pair_1,LogPrompt,InContext,success,1,0,5,0,6,0,6330,3565,9895,6
retrofit,pair_3,LogPrompt,CoT,success,6,0,10,108,124,0,256136,117595,373731,124
starship,pair_2,LogPrompt,InContext,success,1,1,5,0,7,0,8006,4514,12520,7
hugo,pair_1,LogPrompt,InContext,success,4,2,64,1,71,0,181806,67673,249479,71
certbot,pair_4,LogPrompt,CoT,success,1,0,3,0,4,0,3488,2591,6079,4
ColossalAI,pair_2,LogPrompt,CoT,success,348,1,26,100,475,0,1175643,400758,1576401,475
playwright,pair_4,LogPrompt,InContext,success,2,0,5,2,9,0,15528,6222,21750,9
laravel,pair_1,LogPrompt,CoT,success,1,1,12,0,14,0,15121,8301,23422,14
fabric,pair_3,LogPrompt,CoT,success,1,0,6,0,7,0,6311,3510,9821,7
uv,pair_3,LogPrompt,InContext,success,4,1,11,21,37,0,192752,34316,227068,37
youtube-dl,pair_1,LogPrompt,CoT,success,1,0,10,0,11,0,13192,6822,20014,11
gpt_academic,pair_2,LogPrompt,CoT,success,2,2,14,4,22,0,58101,16437,74538,22
PowerShell,pair_1,LogPrompt,InContext,success,0,1,3,2,6,0,8211,4309,12520,6
generative-ai-for-beginners,pair_1,LogPrompt,InContext,success,0,0,4,3,7,0,17395,4098,21493,7
fuels-ts,pair_2,LogPrompt,InContext,success,1,2,12,0,15,0,25062,10461,35523,15
n8n,pair_1,LogPrompt,InContext,success,4,14,126,4,148,0,382857,142773,525630,148
pixijs,pair_2,LogPrompt,CoT,success,1,0,4,0,5,0,27582,2735,30317,5
hugo,pair_4,LogPrompt,InContext,success,6,8,26,2,42,0,94669,35706,130375,42
netdata,pair_1,LogPrompt,InContext,success,12,2,11,11,36,0,130499,33645,164144,36
spring-boot,pair_3,LogPrompt,CoT,success,5,1,7,6,19,0,38423,15456,53879,19
insomnia,pair_3,LogPrompt,CoT,success,1,2,9,0,12,0,46375,7606,53981,12
duckdb,pair_4,LogPrompt,InContext,success,0,16,103,1,120,0,584180,116719,700899,120
mantine,pair_1,LogPrompt,CoT,success,1,0,13,0,14,0,24629,10301,34930,14
dubbo,pair_3,LogPrompt,CoT,success,6,0,10,124,140,0,361486,135143,496629,140
dify,pair_4,LogPrompt,InContext,success,1,5,8,0,14,0,23185,9990,33175,14
n8n,pair_2,LogPrompt,InContext,success,1,10,11,2,24,0,95687,19102,114789,24
lossless-cut,pair_2,LogPrompt,InContext,success,6,0,4,20,30,0,160257,27044,187301,30
LLMs-from-scratch,pair_1,LogPrompt,InContext,success,1,1,7,0,9,0,13178,6103,19281,9
lossless-cut,pair_4,LogPrompt,InContext,success,7,0,4,19,30,0,161249,27325,188574,30
AdminLTE,pair_2,LogPrompt,CoT,success,2,1,5,0,8,0,8828,5061,13889,8
vllm,pair_4,LogPrompt,CoT,success,4,0,9,23,36,0,70291,29828,100119,36
jan,pair_3,LogPrompt,InContext,success,3,3,16,5,27,0,65992,23220,89212,27
wtfpython,pair_3,LogPrompt,InContext,success,1,1,4,0,6,0,6884,3251,10135,6
slate,pair_3,LogPrompt,CoT,success,1,0,5,1,7,0,8500,4157,12657,7
AutoGPT,pair_4,LogPrompt,InContext,success,0,1,5,0,6,4,7280,3502,10782,6
hugo,pair_2,LogPrompt,CoT,success,1,0,66,4,71,0,149774,66591,216365,71
stable-diffusion-webui,pair_2,LogPrompt,CoT,success,1,0,6,0,7,0,4297,3203,7500,7
bubbletea,pair_1,LogPrompt,CoT,success,1,1,8,0,10,0,9421,5554,14975,10
tailwindcss,pair_1,LogPrompt,CoT,success,0,3,18,6,27,0,40751,18842,59593,27
terraform,pair_2,LogPrompt,InContext,success,1,0,6,3,10,0,21094,7534,28628,10
hugo,pair_1,LogPrompt,CoT,success,2,0,66,3,71,0,149471,65782,215253,71
stats,pair_3,LogPrompt,CoT,success,1,0,9,0,10,0,13710,6479,20189,10
cpython,pair_2,LogPrompt,CoT,success,0,0,6,3,9,0,10641,5175,15816,9
mongoose,pair_2,LogPrompt,InContext,success,6,1,6,42,55,0,182232,51376,233608,55
terminal,pair_3,LogPrompt,CoT,success,1,0,2,0,3,0,994,720,1714,3
lossless-cut,pair_3,LogPrompt,CoT,success,1,0,4,25,30,0,147230,26753,173983,30
lossless-cut,pair_2,LogPrompt,CoT,success,1,0,4,25,30,0,146967,26669,173636,30
elasticsearch,pair_2,LogPrompt,CoT,success,1,0,9,0,10,0,17279,7245,24524,10
mongoose,pair_1,LogPrompt,InContext,success,5,4,5,43,57,0,184453,52846,237299,57
ColossalAI,pair_4,LogPrompt,CoT,success,3,1,26,0,30,0,96257,22050,118307,30
alpine,pair_2,LogPrompt,CoT,success,9,0,10,0,19,0,38095,14205,52300,19
spring-boot,pair_4,LogPrompt,CoT,success,1,0,14,0,15,0,15651,8714,24365,15
vllm,pair_2,LogPrompt,CoT,success,2,8,67,1,78,0,361228,70478,431706,78
elasticsearch,pair_1,LogPrompt,CoT,success,1,0,9,0,10,0,17576,7328,24904,10
slate,pair_2,LogPrompt,InContext,success,1,0,5,1,7,0,11545,4920,16465,7
godot,pair_4,LogPrompt,CoT,success,0,0,8,2,10,0,8991,4982,13973,10
LLMs-from-scratch,pair_4,LogPrompt,InContext,success,1,2,6,0,9,0,12935,6292,19227,9
nvm,pair_2,LogPrompt,InContext,success,1,4,4,0,9,0,15636,6337,21973,9
nvm,pair_4,LogPrompt,CoT,success,1,1,7,0,9,0,11416,5851,17267,9
cockroach,pair_2,LogPrompt,CoT,success,1,0,8,3,12,0,12386,5118,17504,12
uv,pair_3,LogPrompt,CoT,success,3,0,12,22,37,0,176421,31485,207906,37
pixijs,pair_1,LogPrompt,InContext,success,1,1,5,1,8,0,11015,4892,15907,8
flask,pair_1,LogPrompt,CoT,success,1,0,8,2,11,0,9625,4800,14425,11
ink-kit,pair_2,LogPrompt,CoT,success,1,0,8,0,9,0,8195,5123,13318,9
netdata,pair_2,LogPrompt,InContext,success,4,3,16,19,42,0,141396,40544,181940,42
julia,pair_1,LogPrompt,CoT,success,0,0,4,1,5,0,4683,2796,7479,5
spark,pair_3,LogPrompt,InContext,success,1,0,2,0,3,0,2916,1561,4477,3
meilisearch,pair_1,LogPrompt,InContext,success,1,1,7,0,9,0,17963,6891,24854,9
code-server,pair_2,LogPrompt,CoT,success,1,1,12,0,14,0,17175,10047,27222,14
flask,pair_2,LogPrompt,InContext,success,1,2,5,2,10,0,16145,5933,22078,10
stable-diffusion-webui,pair_3,LogPrompt,InContext,success,1,0,6,0,7,0,7290,3888,11178,7
pixijs,pair_3,LogPrompt,CoT,success,1,0,6,0,7,0,5228,3765,8993,7
vault,pair_1,LogPrompt,CoT,success,0,0,36,1,37,0,84597,35172,119769,37
laravel,pair_3,LogPrompt,CoT,success,1,1,12,0,14,0,15127,7928,23055,14
ink-kit,pair_1,LogPrompt,CoT,success,1,0,8,0,9,0,8008,5064,13072,9
commander.js,pair_1,LogPrompt,InContext,success,1,2,6,0,9,0,11329,6125,17454,9
gpt4all,pair_1,LogPrompt,CoT,success,1,0,5,0,6,0,6666,3375,10041,6
jan,pair_4,LogPrompt,CoT,success,3,0,14,4,21,0,54547,16462,71009,21
flask,pair_2,LogPrompt,CoT,success,1,0,7,2,10,0,11243,5817,17060,10
stats,pair_4,LogPrompt,CoT,success,1,0,9,0,10,0,13659,6517,20176,10
fuels-ts,pair_3,LogPrompt,InContext,success,14,15,27,4,60,0,260962,55946,316908,60
godot,pair_2,LogPrompt,CoT,success,0,0,8,2,10,0,8771,4914,13685,10
ui,pair_2,LogPrompt,InContext,success,8,0,4,21,33,0,142660,30313,172973,33
julia,pair_1,LogPrompt,InContext,success,0,1,3,1,5,0,6841,3033,9874,5
open-webui,pair_2,LogPrompt,CoT,success,1,0,7,0,8,0,5819,4167,9986,8
retrofit,pair_3,LogPrompt,InContext,success,7,2,8,107,124,0,312409,120622,433031,124
LLMs-from-scratch,pair_1,LogPrompt,CoT,success,1,0,8,0,9,0,8768,5856,14624,9
commander.js,pair_3,LogPrompt,InContext,success,1,3,2,0,6,0,6486,3733,10219,6
cpython,pair_1,LogPrompt,InContext,success,14,16,34,27,91,0,418209,85473,503682,91
retrofit,pair_2,LogPrompt,InContext,success,3,2,7,1,13,0,24244,8305,32549,13
stable-diffusion-webui,pair_2,LogPrompt,InContext,success,1,2,4,0,7,0,7556,3878,11434,7
laravel,pair_4,LogPrompt,CoT,success,1,1,12,0,14,0,15123,7914,23037,14
Ghost,pair_2,LogPrompt,CoT,success,1,0,7,7,15,0,36556,12285,48841,15
spring-boot,pair_2,LogPrompt,CoT,success,1,1,13,0,15,0,15681,8887,24568,15
spring-boot,pair_1,LogPrompt,InContext,success,0,2,12,1,15,0,22234,10116,32350,15
certbot,pair_2,LogPrompt,InContext,success,1,0,2,0,3,0,2429,1253,3682,3
cypress,pair_3,LogPrompt,InContext,success,1,0,5,0,6,0,6429,3437,9866,6
playwright,pair_2,LogPrompt,CoT,success,1,1,21,0,23,0,56749,19812,76561,23
insomnia,pair_1,LogPrompt,CoT,success,1,8,22,0,31,0,100959,24148,125107,31
okhttp,pair_1,LogPrompt,CoT,success,3,1,13,10,27,0,54278,19620,73898,27
RxJava,pair_1,LogPrompt,CoT,success,4,0,8,2,14,0,24520,9364,33884,14
duckdb,pair_3,LogPrompt,CoT,success,1,1,9,0,11,0,11599,7124,18723,11
wtfpython,pair_3,LogPrompt,CoT,success,1,0,5,0,6,0,3749,2653,6402,6
vllm,pair_4,LogPrompt,InContext,success,8,2,7,19,36,0,86793,29825,116618,36
stats,pair_2,LogPrompt,InContext,success,1,1,8,0,10,0,18136,7045,25181,10
fabric,pair_4,LogPrompt,CoT,success,1,1,21,0,23,0,36219,13174,49393,23
hugo,pair_3,LogPrompt,CoT,success,6,0,34,2,42,0,76897,33402,110299,42
n8n,pair_3,LogPrompt,InContext,success,1,7,14,2,24,0,97242,19602,116844,24
terraform,pair_2,LogPrompt,CoT,success,1,0,6,3,10,0,16278,6409,22687,10
certbot,pair_3,LogPrompt,CoT,success,1,0,3,0,4,0,3491,2612,6103,4
starship,pair_1,LogPrompt,InContext,success,1,1,5,0,7,0,8083,4453,12536,7
PowerShell,pair_1,LogPrompt,CoT,success,2,0,4,0,6,0,5358,3163,8521,6
spring-boot,pair_4,LogPrompt,InContext,success,1,8,6,0,15,0,23019,10496,33515,15
starship,pair_3,LogPrompt,InContext,success,1,0,6,0,7,0,7559,4718,12277,7
mantine,pair_1,LogPrompt,InContext,success,1,4,9,0,14,0,31274,11270,42544,14
AutoGPT,pair_4,LogPrompt,CoT,success,0,0,6,0,6,4,4304,3046,7350,6
slate,pair_4,LogPrompt,InContext,success,1,0,5,1,7,0,11634,4707,16341,7
nvm,pair_3,LogPrompt,CoT,success,1,2,3,0,6,0,5062,2718,7780,6
bubbletea,pair_3,LogPrompt,CoT,success,1,0,4,1,6,0,7383,2466,9849,6
youtube-dl,pair_2,LogPrompt,CoT,success,1,0,16,3,20,0,32016,15334,47350,20
PowerShell,pair_4,LogPrompt,InContext,success,1,0,4,0,5,0,5738,2633,8371,5
spring-boot,pair_2,LogPrompt,InContext,success,1,4,10,0,15,0,22167,8987,31154,15
prettier,pair_1,LogPrompt,CoT,success,1,0,7,0,8,0,5618,3961,9579,8
elasticsearch,pair_4,LogPrompt,InContext,failed,0,0,0,0,0,0,0,0,0,0
slate,pair_2,LogPrompt,CoT,success,1,0,5,1,7,0,8110,4696,12806,7
bubbletea,pair_2,LogPrompt,CoT,success,1,1,8,0,10,0,9339,5391,14730,10
laravel,pair_2,LogPrompt,CoT,success,1,1,12,0,14,0,15122,8100,23222,14
ColossalAI,pair_3,LogPrompt,CoT,success,339,2,26,110,477,0,1179598,379063,1558661,477
vllm,pair_1,LogPrompt,CoT,success,2,0,9,14,25,0,41630,18814,60444,25
wtfpython,pair_4,LogPrompt,CoT,success,1,0,5,0,6,0,3748,2557,6305,6
cockroach,pair_3,LogPrompt,CoT,success,1,0,2,0,3,0,1643,1674,3317,3
dubbo,pair_3,LogPrompt,InContext,success,8,3,7,122,140,0,427417,135867,563284,140
grafana,pair_2,LogPrompt,CoT,success,42,2,32,409,485,0,1644584,477624,2122208,485
ionic-framework,pair_3,LogPrompt,CoT,success,8,0,5,3,16,0,31070,9444,40514,16
godot,pair_2,LogPrompt,InContext,success,1,1,7,1,10,0,13470,5411,18881,10
code-server,pair_3,LogPrompt,InContext,success,1,3,10,0,14,0,23498,10024,33522,14
bubbletea,pair_2,LogPrompt,InContext,success,1,1,8,0,10,0,14191,6326,20517,10
mongoose,pair_4,LogPrompt,InContext,success,0,2,4,1,7,0,8099,4370,12469,7
elasticsearch,pair_3,LogPrompt,CoT,success,2,0,72,0,74,0,330747,66274,397021,74
generative-ai-for-beginners,pair_3,LogPrompt,InContext,success,2,1,3,2,8,0,20620,5093,25713,8
pixijs,pair_3,LogPrompt,InContext,success,1,1,5,0,7,0,8841,4276,13117,7
elasticsearch,pair_4,LogPrompt,CoT,failed,0,0,0,0,0,0,0,0,0,0
cypress,pair_2,LogPrompt,CoT,success,1,0,5,0,6,0,3578,2778,6356,6
jan,pair_4,LogPrompt,InContext,success,4,2,12,3,21,0,64203,16365,80568,21
vllm,pair_3,LogPrompt,CoT,success,1,0,9,9,19,0,21354,13389,34743,19
gpt_academic,pair_3,LogPrompt,CoT,success,2,2,14,5,23,0,105147,16578,121725,23
wtfpython,pair_1,LogPrompt,InContext,success,12,1,4,0,17,0,102864,14565,117429,17
django,pair_3,LogPrompt,CoT,success,0,0,4,1,5,0,4313,3051,7364,5
markitdown,pair_3,LogPrompt,CoT,success,1,0,6,0,7,0,5530,3821,9351,7
insomnia,pair_2,LogPrompt,InContext,success,1,23,8,0,32,0,116982,27425,144407,32
llama_index,pair_2,LogPrompt,InContext,success,3,2,7,0,12,0,17951,8697,26648,12
supabase,pair_4,LogPrompt,InContext,success,1,2,13,0,16,0,39099,13716,52815,16
ink-kit,pair_1,LogPrompt,InContext,success,1,1,7,0,9,0,12222,6003,18225,9
terminal,pair_2,LogPrompt,InContext,success,1,1,1,0,3,0,2644,1122,3766,3
LLMs-from-scratch,pair_3,LogPrompt,CoT,success,2,0,8,1,11,0,14448,7501,21949,11
commander.js,pair_2,LogPrompt,CoT,success,1,1,4,0,6,0,3990,3186,7176,6
supabase,pair_1,LogPrompt,InContext,success,1,1,9,0,11,0,16673,6796,23469,11
nvm,pair_2,LogPrompt,CoT,success,1,1,7,0,9,0,11507,5679,17186,9
PowerShell,pair_4,LogPrompt,CoT,success,1,0,4,0,5,0,3299,2367,5666,5
wtfpython,pair_2,LogPrompt,InContext,success,1,1,4,0,6,0,6411,3181,9592,6
open-webui,pair_1,LogPrompt,CoT,success,1,0,7,0,8,0,6120,4169,10289,8
dify,pair_4,LogPrompt,CoT,success,1,0,13,0,14,0,16812,9127,25939,14
dubbo,pair_2,LogPrompt,CoT,success,5,0,10,125,140,0,361385,135058,496443,140
spark,pair_1,LogPrompt,InContext,success,1,1,1,0,3,0,2972,1735,4707,3
django,pair_2,LogPrompt,CoT,success,0,0,4,1,5,0,4617,3041,7658,5
duckdb,pair_2,LogPrompt,CoT,success,13,0,11,120,144,0,1381940,138976,1520916,144
commander.js,pair_4,LogPrompt,CoT,success,1,0,5,0,6,0,3996,3017,7013,6
spark,pair_3,LogPrompt,CoT,success,1,0,2,0,3,0,1396,1318,2714,3
markitdown,pair_1,LogPrompt,CoT,success,3,0,6,0,9,0,12842,5983,18825,9
meilisearch,pair_4,LogPrompt,CoT,success,2,2,16,24,44,0,97634,39574,137208,44
alpine,pair_1,LogPrompt,InContext,success,1,0,4,2,7,0,17911,4422,22333,7
ionic-framework,pair_1,LogPrompt,InContext,success,20,1,4,3,28,0,74236,24680,98916,28
django,pair_1,LogPrompt,InContext,success,7,2,7,18,34,0,72466,31354,103820,34
duckdb,pair_1,LogPrompt,InContext,success,34,20,100,235,389,0,2001984,384595,2386579,389
netdata,pair_1,LogPrompt,CoT,success,10,1,12,13,36,0,113098,31727,144825,36
jan,pair_1,LogPrompt,InContext,success,5,4,15,3,27,0,65099,22346,87445,27
llama_index,pair_2,LogPrompt,CoT,success,2,1,8,1,12,0,12354,7797,20151,12
commander.js,pair_4,LogPrompt,InContext,success,1,2,3,0,6,0,6594,3348,9942,6
lx-music-desktop,pair_1,LogPrompt,InContext,success,1,4,6,0,11,0,15930,7261,23191,11
LLMs-from-scratch,pair_3,LogPrompt,InContext,success,2,1,7,1,11,0,19614,8780,28394,11
bubbletea,pair_4,LogPrompt,InContext,success,1,102,2,0,105,0,737731,102912,840643,105
n8n,pair_4,LogPrompt,InContext,success,8,1,12,38,59,0,138244,53751,191995,59
pandas,pair_1,LogPrompt,CoT,success,4,2,32,1,39,0,118982,31851,150833,39
AdminLTE,pair_1,LogPrompt,CoT,success,0,0,4,3,7,0,22610,4047,26657,7
ionic-framework,pair_3,LogPrompt,InContext,success,9,0,5,2,16,0,38697,13524,52221,16
dubbo,pair_2,LogPrompt,InContext,success,7,3,7,123,140,0,424703,135858,560561,140
pandas,pair_2,LogPrompt,InContext,success,3,3,16,1,23,0,70309,19407,89716,23
meilisearch,pair_3,LogPrompt,CoT,success,4,2,16,13,35,0,79426,29553,108979,35
PowerShell,pair_2,LogPrompt,CoT,success,1,0,4,1,6,0,5214,3760,8974,6
spark,pair_4,LogPrompt,CoT,success,1,0,2,0,3,0,1394,1326,2720,3
open-webui,pair_3,LogPrompt,InContext,success,2,2,5,45,54,0,172931,50001,222932,54
prettier,pair_3,LogPrompt,InContext,success,152,4,3,32,191,0,483155,188436,671591,191
gpt4all,pair_2,LogPrompt,InContext,success,1,3,2,0,6,0,9105,3642,12747,6
grafana,pair_2,LogPrompt,InContext,success,32,2,32,419,485,0,1870075,482209,2352284,485
AutoGPT,pair_3,LogPrompt,CoT,success,0,0,6,1,7,0,6556,3973,10529,7
spark,pair_2,LogPrompt,CoT,success,0,0,2,0,2,1,840,778,1618,2
bruno,pair_1,LogPrompt,InContext,success,1,4,10,0,15,0,20202,10547,30749,15
fuels-ts,pair_2,LogPrompt,CoT,success,1,0,14,0,15,0,18264,9517,27781,15
stats,pair_1,LogPrompt,InContext,success,1,0,9,0,10,0,18826,6978,25804,10
prettier,pair_2,LogPrompt,InContext,success,1,2,6,0,9,0,10361,5080,15441,9
Ghost,pair_2,LogPrompt,InContext,success,6,0,7,2,15,0,43456,12596,56052,15
LLMs-from-scratch,pair_4,LogPrompt,CoT,success,1,0,8,0,9,0,8764,5374,14138,9
lossless-cut,pair_3,LogPrompt,InContext,success,5,0,4,21,30,0,161672,27204,188876,30
insomnia,pair_3,LogPrompt,InContext,success,1,6,5,0,12,0,51964,8368,60332,12
ionic-framework,pair_1,LogPrompt,CoT,success,17,0,5,6,28,0,60489,18699,79188,28
okhttp,pair_3,LogPrompt,CoT,success,1,0,14,6,21,0,35083,14398,49481,21
vault,pair_3,LogPrompt,InContext,success,0,0,2,1,3,0,2158,1410,3568,3
cpython,pair_4,LogPrompt,CoT,success,1,1,145,1,148,0,487039,140460,627499,148
open-webui,pair_2,LogGPT,2,success,1,2,9,0,12,0,5516,747,6263,12
fuels-ts,pair_1,LogGPT,2,success,1,12,120,1,134,0,233202,7316,240518,134
ui,pair_2,LogGPT,1,success,1,0,5,0,6,96,2281,1610,3891,6
spark,pair_1,LogGPT,2,success,1,0,3,0,4,0,1817,330,2147,4
n8n,pair_1,LogGPT,1,success,4,12,422,19,457,10,384783,306834,691617,457
cypress,pair_1,LogGPT,1,success,1,0,8,0,9,0,4064,3286,7350,9
open-webui,pair_1,LogGPT,1,success,1,2,9,0,12,0,5631,4481,10112,12
vllm,pair_4,LogGPT,2,success,8,3,9,80,100,0,93697,5539,99236,100
n8n,pair_4,LogGPT,2,success,21,4,17,130,172,0,135917,9109,145026,172
htmx,pair_1,LogGPT,1,success,1,0,5,0,6,8,2143,1244,3387,6
netdata,pair_3,LogGPT,1,success,7,8,83,50,148,88,127210,91929,219139,148
n8n,pair_2,LogGPT,1,success,3,5,25,2,35,23,78497,18138,96635,35
pixijs,pair_1,LogGPT,2,success,3,2,10,1,16,0,9204,1120,10324,16
AutoGPT,pair_4,LogGPT,2,success,11,0,9,1,21,0,1238596,1953,1240549,21
markitdown,pair_3,LogGPT,1,success,1,0,10,0,11,0,5299,4344,9643,11
laravel,pair_2,LogGPT,1,success,1,3,18,1,23,2,13380,11638,25018,23
wtfpython,pair_1,LogGPT,1,success,1,1,6,1,9,37,8366,3244,11610,9
okhttp,pair_1,LogGPT,2,success,12,5,21,31,69,1,63909,4814,68723,69
django,pair_1,LogGPT,2,success,18,1,18,64,101,0,72390,6287,78677,101
youtube-dl,pair_1,LogGPT,2,success,1,1,19,0,21,0,11369,1035,12404,21
slate,pair_3,LogGPT,1,success,1,0,8,2,11,3,5545,4693,10238,11
open-webui,pair_1,LogGPT,2,success,1,1,10,0,12,0,5405,672,6077,12
ink-kit,pair_1,LogGPT,1,success,1,0,16,0,17,0,9517,8013,17530,17
llama_index,pair_4,LogGPT,2,success,2,0,35,1,38,0,27678,1813,29491,38
starship,pair_4,LogGPT,2,success,1,2,7,0,10,0,5094,676,5770,10
ink-kit,pair_3,LogGPT,2,success,1,0,11,0,12,0,5638,545,6183,12
mongoose,pair_4,LogGPT,1,success,1,1,8,0,10,0,4983,4420,9403,10
terraform,pair_3,LogGPT,2,success,2,1,6,2,11,0,5971,679,6650,11
vllm,pair_1,LogGPT,2,success,3,0,12,48,63,0,49770,2645,52415,63
bubbletea,pair_1,LogGPT,1,success,1,1,15,0,17,1,9952,8691,18643,17
cockroach,pair_3,LogGPT,2,success,1,0,3,0,4,0,1969,314,2283,4
cpython,pair_4,LogGPT,2,success,2,1,454,3,460,0,548140,23439,571579,460
stats,pair_3,LogGPT,2,success,1,1,20,0,22,0,11013,1114,12127,22
ollama,pair_1,LogGPT,2,success,1,0,6,4,11,0,6969,554,7523,11
playwright,pair_4,LogGPT,1,success,4,1,6,9,20,0,13260,12086,25346,20
dubbo,pair_3,LogGPT,1,success,3,0,14,415,432,15,394410,359594,754004,432
markitdown,pair_2,LogGPT,1,success,5,0,9,1,15,3,9408,7937,17345,15
julia,pair_2,LogGPT,2,success,1,0,8,0,9,0,4001,410,4411,9
nvm,pair_4,LogGPT,1,success,1,2,10,1,14,3,8461,7550,16011,14
terraform,pair_2,LogGPT,2,success,2,0,10,10,22,0,19794,1055,20849,22
prettier,pair_2,LogGPT,1,success,1,1,10,0,12,1,5389,4511,9900,12
PowerShell,pair_1,LogGPT,2,success,3,1,5,2,11,0,6031,790,6821,11
spring-boot,pair_4,LogGPT,1,success,1,1,25,2,29,0,18962,16799,35761,29
prettier,pair_3,LogGPT,2,success,503,2,9,110,624,0,492333,78338,570671,624
fabric,pair_3,LogGPT,2,success,1,1,9,0,11,0,6608,730,7338,11
jan,pair_1,LogGPT,2,success,4,3,43,20,70,0,64432,3569,68001,70
okhttp,pair_3,LogGPT,1,success,2,2,22,17,43,6,31922,28952,60874,43
bubbletea,pair_3,LogGPT,1,success,1,0,5,0,6,4,2077,1243,3320,6
markitdown,pair_4,LogGPT,2,success,22,0,9,19,50,0,38933,4303,43236,50
markitdown,pair_3,LogGPT,2,success,1,0,10,0,11,0,5498,482,5980,11
cypress,pair_3,LogGPT,2,success,1,0,8,0,9,0,4090,441,4531,9
cpython,pair_1,LogGPT,1,success,16,6,115,7,144,126,214734,87716,302450,144
AutoGPT,pair_3,LogGPT,2,success,3,0,9,0,12,0,7401,776,8177,12
starship,pair_1,LogGPT,2,success,1,1,8,0,10,0,5117,638,5755,10
meilisearch,pair_2,LogGPT,1,success,1,3,18,0,22,0,12188,10069,22257,22
htmx,pair_2,LogGPT,1,success,1,0,9,0,10,0,4847,4440,9287,10
fabric,pair_4,LogGPT,1,success,1,1,38,0,40,8,28218,25050,53268,40
terminal,pair_4,LogGPT,2,success,1,0,2,0,3,0,1187,208,1395,3
retrofit,pair_2,LogGPT,2,success,6,0,15,5,26,0,20673,1655,22328,26
LLMs-from-scratch,pair_4,LogGPT,2,success,1,3,15,0,19,0,10135,1094,11229,19
neovim,pair_1,LogGPT,2,success,1,8,181,7,197,4,207971,8321,216292,197
cypress,pair_2,LogGPT,2,success,1,1,7,0,9,0,3853,532,4385,9
pandas,pair_1,LogGPT,1,success,7,2,69,7,85,23,88162,63187,151349,85
gpt4all,pair_1,LogGPT,1,success,1,0,8,0,9,1,5442,4679,10121,9
slate,pair_1,LogGPT,1,success,12,2,82,44,140,3,103915,90844,194759,140
lx-music-desktop,pair_1,LogGPT,1,success,2,2,13,0,17,3,8912,7667,16579,17
ionic-framework,pair_2,LogGPT,2,success,14,0,8,5,27,0,21739,2607,24346,27
meilisearch,pair_1,LogGPT,1,success,1,1,20,0,22,0,11307,9489,20796,22
tailwindcss,pair_2,LogGPT,2,success,4,5,40,5,54,0,47914,3033,50947,54
n8n,pair_3,LogGPT,2,success,4,8,41,6,59,0,134648,3482,138130,59
fabric,pair_2,LogGPT,1,success,2,1,27,1,31,4,21052,19188,40240,31
ColossalAI,pair_2,LogGPT,2,success,1011,9,56,481,1557,0,1428696,166593,1595289,1557
flask,pair_2,LogGPT,2,success,3,0,10,7,20,0,12578,1163,13741,20
pixijs,pair_3,LogGPT,2,success,2,2,8,0,12,0,5863,847,6710,12
django,pair_3,LogGPT,2,success,3,0,6,0,9,0,4849,650,5499,9
stable-diffusion-webui,pair_4,LogGPT,1,success,1,1,8,0,10,0,4426,3449,7875,10
julia,pair_2,LogGPT,1,success,1,0,8,0,9,0,3990,3111,7101,9
terraform,pair_1,LogGPT,1,success,3,0,10,6,19,5,14761,12746,27507,19
jan,pair_2,LogGPT,2,success,4,4,42,20,70,0,64236,3843,68079,70
ink-kit,pair_1,LogGPT,2,success,1,0,16,0,17,0,9215,748,9963,17
duckdb,pair_4,LogGPT,1,success,1,3,56,2,62,323,59079,46991,106070,62
django,pair_3,LogGPT,1,success,3,2,4,0,9,0,4795,4094,8889,9
netdata,pair_4,LogGPT,2,success,12,3,24,40,79,0,82695,4470,87165,79
godot,pair_1,LogGPT,1,success,2,9,99,0,110,121,100415,72117,172532,110
cypress,pair_1,LogGPT,2,success,1,1,7,0,9,0,4132,583,4715,9
ink-kit,pair_3,LogGPT,1,success,1,1,10,0,12,0,5568,4601,10169,12
ColossalAI,pair_4,LogGPT,2,success,6,2,62,3,73,0,102286,3654,105940,73
tailwindcss,pair_1,LogGPT,2,success,5,4,34,14,57,1,50897,2996,53893,57
htmx,pair_1,LogGPT,2,success,2,0,5,7,14,0,14718,800,15518,14
lossless-cut,pair_3,LogGPT,2,success,6,0,5,79,90,0,163579,4280,167859,90
starship,pair_2,LogGPT,2,success,1,2,7,0,10,0,5123,731,5854,10
alpine,pair_2,LogGPT,1,success,27,3,18,1,49,0,40182,36409,76591,49
insomnia,pair_3,LogGPT,2,success,3,4,16,0,23,0,51839,1562,53401,23
playwright,pair_3,LogGPT,1,success,2,1,15,8,26,1,19220,16776,35996,26
dubbo,pair_3,LogGPT,2,success,4,1,13,429,447,0,420223,17153,437376,447
fuels-ts,pair_2,LogGPT,2,success,1,5,22,0,28,0,21559,1625,23184,28
AutoGPT,pair_4,LogGPT,1,success,0,0,9,2,11,10,146766,4568,151334,11
PowerShell,pair_2,LogGPT,1,success,3,0,6,2,11,0,5964,5284,11248,11
godot,pair_4,LogGPT,1,success,3,2,9,4,18,0,10427,8954,19381,18
prettier,pair_2,LogGPT,2,success,1,3,9,0,13,0,7402,874,8276,13
hugo,pair_3,LogGPT,2,success,17,7,76,8,108,0,93736,7237,100973,108
spring-boot,pair_4,LogGPT,2,success,1,2,24,2,29,0,19111,1487,20598,29
terminal,pair_1,LogGPT,1,success,1,0,2,0,3,0,1212,763,1975,3
cypress,pair_4,LogGPT,1,success,1,0,8,0,9,0,4026,3321,7347,9
mantine,pair_1,LogGPT,1,success,1,1,28,1,31,1,22552,16108,38660,31
lx-music-desktop,pair_1,LogGPT,2,success,2,2,16,0,20,0,15074,1096,16170,20
cpython,pair_1,LogGPT,2,success,39,15,121,95,270,0,415973,18126,434099,270
alpine,pair_1,LogGPT,1,success,1,0,5,0,6,9,2124,1622,3746,6
AutoGPT,pair_3,LogGPT,1,success,1,2,7,1,11,1,5962,5241,11203,11
insomnia,pair_1,LogGPT,2,success,4,50,33,0,87,0,133804,9351,143155,87
dubbo,pair_4,LogGPT,1,success,3,0,14,415,432,15,395326,360515,755841,432
django,pair_4,LogGPT,2,success,1,1,11,0,13,0,8878,666,9544,13
supabase,pair_2,LogGPT,2,success,2,2,37,1,42,0,39484,1987,41471,42
laravel,pair_3,LogGPT,1,success,2,1,20,0,23,2,13561,11457,25018,23
ColossalAI,pair_3,LogGPT,1,success,889,3,36,457,1385,174,1146576,1042471,2189047,1385
netdata,pair_1,LogGPT,2,success,22,6,24,52,104,0,126758,7387,134145,104
prettier,pair_1,LogGPT,1,success,1,2,8,0,11,1,4889,4052,8941,11
alpine,pair_2,LogGPT,2,success,28,2,19,0,49,0,40023,5039,45062,49
julia,pair_1,LogGPT,1,success,2,0,7,1,10,0,5346,4518,9864,10
gpt4all,pair_1,LogGPT,2,success,1,1,8,0,10,1,7030,582,7612,10
fuels-ts,pair_1,LogGPT,1,success,1,5,57,1,64,70,99985,37281,137266,64
elasticsearch,pair_4,LogGPT,1,failed,0,0,0,0,0,0,0,0,0,0
django,pair_2,LogGPT,2,success,3,1,5,1,10,0,5257,774,6031,10
code-server,pair_3,LogGPT,2,success,1,2,24,0,27,0,19541,1325,20866,27
cpython,pair_3,LogGPT,2,success,2,1,9,7,19,0,11666,1144,12810,19
starship,pair_2,LogGPT,1,success,1,1,8,0,10,0,5151,4213,9364,10
playwright,pair_1,LogGPT,2,success,6,0,7,53,66,0,96753,3277,100030,66
bubbletea,pair_2,LogGPT,2,success,2,2,13,0,17,0,11180,1084,12264,17
commander.js,pair_2,LogGPT,1,success,1,2,6,0,9,0,4145,3641,7786,9
godot,pair_2,LogGPT,2,success,4,1,10,3,18,0,10085,1137,11222,18
flask,pair_1,LogGPT,1,success,2,1,10,5,18,0,10056,8582,18638,18
spark,pair_4,LogGPT,2,success,1,0,3,0,4,1,1742,261,2003,4
n8n,pair_1,LogGPT,2,success,4,37,405,21,467,0,403034,21812,424846,467
pandas,pair_4,LogGPT,2,failed,0,0,0,0,0,0,0,0,0,0
hugo,pair_4,LogGPT,2,success,20,9,74,5,108,0,91607,7278,98885,108
okhttp,pair_2,LogGPT,1,success,8,1,23,18,50,6,37038,33181,70219,50
supabase,pair_1,LogGPT,1,success,1,1,15,0,17,2,9497,8520,18017,17
AutoGPT,pair_1,LogGPT,2,success,12,0,9,1,22,0,1262027,2461,1264488,22
code-server,pair_3,LogGPT,1,success,1,1,25,0,27,0,19546,17504,37050,27
vault,pair_3,LogGPT,2,success,1,0,3,0,4,0,1266,254,1520,4
netdata,pair_3,LogGPT,2,success,17,11,82,126,236,0,298792,11957,310749,236
stable-diffusion-webui,pair_3,LogGPT,2,success,1,0,9,0,10,0,4099,496,4595,10
spark,pair_2,LogGPT,1,success,1,1,2,0,4,0,1783,1358,3141,4
pixijs,pair_1,LogGPT,1,success,3,2,10,1,16,0,9056,7513,16569,16
ionic-framework,pair_4,LogGPT,2,success,3,1,7,103,114,0,99291,4777,104068,114
fuels-ts,pair_2,LogGPT,1,success,1,3,23,0,27,1,20742,18281,39023,27
insomnia,pair_3,LogGPT,1,success,3,2,18,0,23,0,51739,11129,62868,23
llama_index,pair_2,LogGPT,2,success,2,2,13,6,23,0,14440,1274,15714,23
grafana,pair_2,LogGPT,1,success,44,2,48,941,1035,569,1033722,922035,1955757,1035
code-server,pair_1,LogGPT,2,success,1,2,23,0,26,0,18831,1406,20237,26
AdminLTE,pair_1,LogGPT,1,success,1,1,4,0,6,9,1996,1178,3174,6
pandas,pair_4,LogGPT,1,failed,0,0,0,0,0,0,0,0,0,0
grafana,pair_3,LogGPT,1,success,1,2,11,0,14,8,16900,5474,22374,14
jan,pair_2,LogGPT,1,success,4,1,45,10,60,10,46522,33048,79570,60
flask,pair_1,LogGPT,2,success,2,1,10,5,18,0,9843,976,10819,18
insomnia,pair_2,LogGPT,2,success,2,54,32,1,89,0,134252,9658,143910,89
certbot,pair_1,LogGPT,2,success,1,0,3,0,4,0,1355,264,1619,4
playwright,pair_2,LogGPT,1,success,1,0,47,1,49,12,46632,40526,87158,49
grafana,pair_1,LogGPT,2,success,2,1,12,2,17,0,11894,909,12803,17
duckdb,pair_4,LogGPT,2,success,1,6,376,2,385,0,598711,15464,614175,385
jan,pair_3,LogGPT,2,success,5,2,44,21,72,0,66487,3560,70047,72
gpt_academic,pair_2,LogGPT,1,success,4,3,30,7,44,8,40118,23073,63191,44
dify,pair_3,LogGPT,1,success,1,5,31,15,52,2,35965,30945,66910,52
open-webui,pair_2,LogGPT,1,success,1,1,10,0,12,0,5330,4447,9777,12
LLMs-from-scratch,pair_2,LogGPT,2,success,3,0,17,0,20,0,11393,1108,12501,20
commander.js,pair_2,LogGPT,2,success,1,1,7,0,9,0,4387,598,4985,9
ColossalAI,pair_3,LogGPT,2,success,997,9,56,497,1559,0,1432523,164775,1597298,1559
cpython,pair_2,LogGPT,2,success,3,1,9,7,20,0,12148,1311,13459,20
dify,pair_4,LogGPT,2,success,1,3,24,0,28,0,19083,1407,20490,28
generative-ai-for-beginners,pair_3,LogGPT,1,success,1,0,4,0,5,11,2002,1242,3244,5
slate,pair_4,LogGPT,1,success,1,0,7,2,10,3,5503,4457,9960,10
nvm,pair_3,LogGPT,2,success,1,2,5,0,8,0,5821,547,6368,8
pixijs,pair_4,LogGPT,1,success,2,0,10,0,12,0,5489,4460,9949,12
generative-ai-for-beginners,pair_1,LogGPT,2,success,2,0,4,8,14,0,15680,846,16526,14
julia,pair_1,LogGPT,2,success,3,0,7,0,10,0,5550,719,6269,10
nvm,pair_4,LogGPT,2,success,3,1,13,0,17,0,12764,1049,13813,17
lossless-cut,pair_1,LogGPT,1,success,1,0,5,0,6,84,2447,1807,4254,6
cockroach,pair_1,LogGPT,2,success,2,3,16,7,28,0,24478,1543,26021,28
tailwindcss,pair_2,LogGPT,1,success,1,2,38,7,48,6,37689,33068,70757,48
PowerShell,pair_3,LogGPT,1,success,3,1,5,2,11,0,6015,5234,11249,11
laravel,pair_4,LogGPT,2,success,1,2,21,1,25,0,21663,1171,22834,25
spring-boot,pair_3,LogGPT,1,success,9,3,10,22,44,4,39348,35319,74667,44
gpt_academic,pair_1,LogGPT,1,success,2,5,28,11,46,11,63909,23317,87226,46
starship,pair_4,LogGPT,1,success,1,1,8,0,10,0,4949,4124,9073,10
grafana,pair_1,LogGPT,1,success,1,1,12,1,15,2,8469,7463,15932,15
meilisearch,pair_2,LogGPT,2,success,1,2,19,0,22,0,12061,1240,13301,22
mongoose,pair_3,LogGPT,2,success,3,0,5,7,15,0,16148,1031,17179,15
grafana,pair_4,LogGPT,2,success,312,2,11,1,326,0,391362,50727,442089,326
markitdown,pair_1,LogGPT,1,success,4,0,9,2,15,3,9609,8555,18164,15
elasticsearch,pair_1,LogGPT,1,success,1,1,21,0,23,0,14335,12138,26473,23
slate,pair_2,LogGPT,1,success,1,2,6,2,11,2,6341,5320,11661,11
uv,pair_3,LogGPT,2,success,8,3,21,74,106,0,284366,5058,289424,106
meilisearch,pair_3,LogGPT,2,success,11,5,41,44,101,0,107962,5628,113590,101
elasticsearch,pair_3,LogGPT,2,success,3,4,208,1,216,0,370196,10160,380356,216
hugo,pair_1,LogGPT,2,success,9,125,77,6,217,0,191275,18868,210143,217
flask,pair_2,LogGPT,1,success,3,0,10,7,20,0,12287,11215,23502,20
stable-diffusion-webui,pair_2,LogGPT,2,success,1,0,9,0,10,0,4361,540,4901,10
commander.js,pair_3,LogGPT,1,success,1,1,7,0,9,0,4284,3762,8046,9
prettier,pair_4,LogGPT,2,success,1,4,28,0,33,0,22012,1896,23908,33
AdminLTE,pair_1,LogGPT,2,success,3,0,5,7,15,0,24628,945,25573,15
llama_index,pair_1,LogGPT,2,success,2,0,35,1,38,0,27726,1963,29689,38
vllm,pair_3,LogGPT,1,success,4,1,11,30,46,0,27597,24236,51833,46
gpt4all,pair_4,LogGPT,1,success,1,0,8,0,9,1,5655,4632,10287,9
supabase,pair_3,LogGPT,2,success,1,0,18,0,19,0,12791,797,13588,19
pixijs,pair_2,LogGPT,1,success,0,0,7,1,8,0,27895,3499,31394,8
mongoose,pair_1,LogGPT,2,success,11,1,12,147,171,0,276143,7561,283704,171
Ghost,pair_1,LogGPT,1,success,10,0,23,26,59,57,140145,24923,165068,59
dify,pair_1,LogGPT,1,success,1,1,8,0,10,0,4359,3754,8113,10
bubbletea,pair_4,LogGPT,1,success,1,178,38,0,217,124,465327,83561,548888,217
retrofit,pair_2,LogGPT,1,success,4,1,12,3,20,6,13097,11381,24478,20
gpt4all,pair_2,LogGPT,2,success,1,0,9,0,10,0,6795,464,7259,10
wtfpython,pair_1,LogGPT,2,success,39,0,7,0,46,0,102004,6150,108154,46
pixijs,pair_3,LogGPT,1,success,2,0,10,0,12,0,5598,4809,10407,12
slate,pair_4,LogGPT,2,success,1,0,7,5,13,0,10587,600,11187,13
dify,pair_4,LogGPT,1,success,1,2,24,0,27,1,17743,15563,33306,27
vllm,pair_4,LogGPT,1,success,3,2,10,78,93,7,83437,70715,154152,93
playwright,pair_4,LogGPT,2,success,4,2,5,9,20,0,13723,1290,15013,20
certbot,pair_3,LogGPT,1,success,1,0,7,0,8,0,4262,3824,8086,8
youtube-dl,pair_2,LogGPT,1,success,3,6,28,8,45,2,31530,27850,59380,45
terminal,pair_1,LogGPT,2,success,1,0,2,0,3,0,1061,210,1271,3
terminal,pair_3,LogGPT,1,success,1,0,2,0,3,0,1115,795,1910,3
stats,pair_4,LogGPT,2,success,1,2,19,0,22,0,10801,1238,12039,22
certbot,pair_4,LogGPT,2,success,1,0,7,0,8,0,4492,432,4924,8
terraform,pair_3,LogGPT,1,success,2,1,6,2,11,0,6081,4863,10944,11
Ghost,pair_2,LogGPT,2,success,6,3,10,21,40,0,53764,3007,56771,40
fzf,pair_1,LogGPT,1,success,1,2,21,0,24,0,13979,12392,26371,24
netdata,pair_2,LogGPT,2,success,13,5,48,63,129,0,132252,6781,139033,129
supabase,pair_2,LogGPT,1,success,0,3,36,0,39,3,31338,27782,59120,39
commander.js,pair_1,LogGPT,1,success,1,1,13,1,16,0,8685,7268,15953,16
certbot,pair_1,LogGPT,1,success,1,0,3,0,4,0,1460,1077,2537,4
code-server,pair_2,LogGPT,2,success,1,3,25,0,29,0,20287,1436,21723,29
playwright,pair_1,LogGPT,1,success,3,0,7,41,51,15,59815,41510,101325,51
LLMs-from-scratch,pair_2,LogGPT,1,success,3,1,16,0,20,0,11802,10081,21883,20
pandas,pair_2,LogGPT,2,success,8,2,48,4,62,0,68576,3548,72124,62
vault,pair_1,LogGPT,2,success,3,5,109,0,117,0,144167,5450,149617,117
spark,pair_3,LogGPT,1,success,1,1,2,0,4,0,1726,1345,3071,4
AutoGPT,pair_2,LogGPT,2,success,1,1,8,0,10,0,5263,574,5837,10
stable-diffusion-webui,pair_3,LogGPT,1,success,1,1,8,0,10,0,3992,3578,7570,10
insomnia,pair_2,LogGPT,1,success,3,32,29,0,64,25,92290,45609,137899,64
ui,pair_1,LogGPT,2,success,2,0,5,7,14,0,16300,766,17066,14
dify,pair_2,LogGPT,2,success,3,5,28,13,49,0,33821,2524,36345,49
prettier,pair_1,LogGPT,2,success,1,0,11,0,12,0,6619,630,7249,12
duckdb,pair_2,LogGPT,1,success,28,2,21,363,414,52,1311346,286662,1598008,414
stats,pair_3,LogGPT,1,success,1,1,20,0,22,0,10637,8896,19533,22
supabase,pair_4,LogGPT,1,success,0,3,36,0,39,3,31556,27640,59196,39
godot,pair_1,LogGPT,2,success,2,17,212,0,231,0,524727,11136,535863,231
laravel,pair_1,LogGPT,1,success,2,1,20,0,23,2,13058,11653,24711,23
generative-ai-for-beginners,pair_1,LogGPT,1,success,1,0,4,1,6,8,3957,1720,5677,6
uv,pair_2,LogGPT,2,success,6,4,20,78,108,0,289577,5196,294773,108
llama_index,pair_2,LogGPT,1,success,1,2,13,7,23,0,14598,12608,27206,23
julia,pair_3,LogGPT,1,success,2,1,6,1,10,0,5616,4496,10112,10
cockroach,pair_3,LogGPT,1,success,1,0,3,0,4,0,1944,1670,3614,4
supabase,pair_1,LogGPT,2,success,1,0,18,0,19,0,13156,872,14028,19
julia,pair_3,LogGPT,2,success,3,0,7,0,10,0,5389,670,6059,10
open-webui,pair_3,LogGPT,1,success,1,1,9,110,121,43,117922,100988,218910,121
jan,pair_1,LogGPT,1,success,5,2,44,9,60,10,46518,32434,78952,60
generative-ai-for-beginners,pair_3,LogGPT,2,success,2,0,4,10,16,0,19149,835,19984,16
wtfpython,pair_2,LogGPT,2,success,1,1,6,0,8,0,3806,455,4261,8
elasticsearch,pair_2,LogGPT,2,success,1,1,20,0,22,0,13266,1165,14431,22
n8n,pair_4,LogGPT,1,success,9,1,18,132,160,12,117091,108544,225635,160
wtfpython,pair_4,LogGPT,1,success,1,2,5,0,8,0,3820,3269,7089,8
starship,pair_1,LogGPT,1,success,1,2,7,0,10,0,5064,4313,9377,10
stats,pair_2,LogGPT,2,success,1,1,21,0,23,0,11142,1135,12277,23
django,pair_1,LogGPT,1,success,17,2,11,63,93,8,61149,51084,112233,93
lossless-cut,pair_2,LogGPT,2,success,4,0,5,81,90,0,163658,4062,167720,90
PowerShell,pair_4,LogGPT,2,success,1,1,6,0,8,0,3653,477,4130,8
grafana,pair_2,LogGPT,2,success,92,11,90,1411,1604,1,1913424,76773,1990197,1604
PowerShell,pair_3,LogGPT,2,success,3,0,6,2,11,0,5932,708,6640,11
wtfpython,pair_4,LogGPT,2,success,1,0,7,0,8,0,4024,480,4504,8
RxJava,pair_1,LogGPT,1,success,7,1,10,3,21,10,14985,13115,28100,21
open-webui,pair_4,LogGPT,1,success,2,0,8,0,10,0,4897,4243,9140,10
flask,pair_4,LogGPT,1,success,4,2,12,158,176,0,157877,136281,294158,176
ionic-framework,pair_3,LogGPT,2,success,30,0,8,6,44,0,38230,4985,43215,44
ionic-framework,pair_1,LogGPT,2,success,67,1,7,7,82,0,75850,10259,86109,82
certbot,pair_2,LogGPT,2,success,1,0,3,0,4,0,1360,266,1626,4
ColossalAI,pair_2,LogGPT,1,success,880,3,36,468,1387,170,1151457,1044166,2195623,1387
terraform,pair_1,LogGPT,2,success,5,0,10,9,24,0,21213,1444,22657,24
LLMs-from-scratch,pair_3,LogGPT,2,success,3,0,17,5,25,0,17277,1235,18512,25
pandas,pair_1,LogGPT,2,success,7,15,78,8,108,0,135611,6540,142151,108
certbot,pair_4,LogGPT,1,success,1,0,7,0,8,0,4446,3840,8286,8
stats,pair_2,LogGPT,1,success,1,1,21,0,23,0,11242,9112,20354,23
llama_index,pair_4,LogGPT,1,success,2,1,33,1,37,1,26506,23656,50162,37
terraform,pair_2,LogGPT,1,success,1,0,10,6,17,5,12934,11178,24112,17
commander.js,pair_4,LogGPT,2,success,1,1,7,0,9,0,4469,539,5008,9
AdminLTE,pair_2,LogGPT,1,success,2,0,10,3,15,0,10093,8897,18990,15
fuels-ts,pair_3,LogGPT,1,success,16,3,57,25,101,80,190195,64965,255160,101
gpt4all,pair_3,LogGPT,2,success,1,1,8,0,10,0,7014,601,7615,10
duckdb,pair_1,LogGPT,2,success,54,10,373,842,1279,1,2020397,77344,2097741,1279
duckdb,pair_2,LogGPT,2,success,40,0,23,403,466,0,1471820,27224,1499044,466
godot,pair_2,LogGPT,1,success,3,1,10,4,18,0,10525,8810,19335,18
gpt4all,pair_4,LogGPT,2,success,0,1,8,1,10,0,7031,567,7598,10
stats,pair_1,LogGPT,2,success,1,2,20,0,23,0,11265,1182,12447,23
retrofit,pair_3,LogGPT,1,success,9,1,17,368,395,4,314231,271169,585400,395
youtube-dl,pair_1,LogGPT,1,success,1,0,20,0,21,0,11394,9365,20759,21
ionic-framework,pair_3,LogGPT,1,success,26,0,8,7,41,3,33795,29863,63658,41
RxJava,pair_1,LogGPT,2,success,15,1,10,5,31,0,28177,2766,30943,31
PowerShell,pair_1,LogGPT,1,success,3,0,6,2,11,0,6125,5319,11444,11
netdata,pair_1,LogGPT,1,success,4,4,26,25,59,45,56034,39024,95058,59
ionic-framework,pair_2,LogGPT,1,success,13,1,7,4,25,2,18621,16134,34755,25
stable-diffusion-webui,pair_1,LogGPT,2,success,1,1,8,0,10,0,4380,569,4949,10
bubbletea,pair_4,LogGPT,2,success,1,327,13,0,341,0,734185,45032,779217,341
vault,pair_1,LogGPT,1,success,3,2,74,0,79,38,79428,60179,139607,79
PowerShell,pair_2,LogGPT,2,success,3,0,6,2,11,0,6094,693,6787,11
gpt4all,pair_2,LogGPT,1,success,1,0,8,0,9,1,5339,4579,9918,9
jan,pair_4,LogGPT,2,success,6,4,27,17,54,0,68456,3219,71675,54
fzf,pair_1,LogGPT,2,success,1,6,17,0,24,0,13948,1537,15485,24
playwright,pair_3,LogGPT,2,success,2,2,15,8,27,0,21428,1530,22958,27
spring-boot,pair_2,LogGPT,2,success,1,1,25,2,29,0,19340,1392,20732,29
cypress,pair_3,LogGPT,1,success,1,0,8,0,9,0,3889,3244,7133,9
commander.js,pair_4,LogGPT,1,success,1,1,7,0,9,0,4431,3551,7982,9
django,pair_2,LogGPT,1,success,1,0,6,3,10,0,5196,4572,9768,10
nvm,pair_1,LogGPT,2,success,1,2,5,0,8,0,5725,605,6330,8
gpt_academic,pair_3,LogGPT,1,success,5,2,31,6,44,12,46694,23159,69853,44
certbot,pair_2,LogGPT,1,success,1,0,3,0,4,0,1514,1052,2566,4
vault,pair_2,LogGPT,2,success,1,0,3,0,4,0,1393,219,1612,4
wtfpython,pair_3,LogGPT,1,success,1,1,6,0,8,0,3648,3300,6948,8
prettier,pair_3,LogGPT,1,success,472,1,9,141,623,1,491156,456532,947688,623
uv,pair_3,LogGPT,1,success,5,1,16,43,65,41,163199,24585,187784,65
pandas,pair_3,LogGPT,2,success,1,11,143,0,155,0,153165,7112,160277,155
markitdown,pair_4,LogGPT,1,success,22,1,8,19,50,0,39005,33351,72356,50
playwright,pair_2,LogGPT,2,success,1,1,58,1,61,0,67641,2490,70131,61
lossless-cut,pair_2,LogGPT,1,success,1,0,5,0,6,84,2318,1814,4132,6
n8n,pair_3,LogGPT,1,success,3,3,25,1,32,27,75132,16481,91613,32
hugo,pair_1,LogGPT,1,success,3,73,121,5,202,15,164835,142711,307546,202
elasticsearch,pair_2,LogGPT,1,success,1,1,20,0,22,0,13822,11631,25453,22
laravel,pair_4,LogGPT,1,success,1,1,20,1,23,2,13275,11473,24748,23
dubbo,pair_4,LogGPT,2,success,3,3,11,430,447,0,421970,17132,439102,447
spring-boot,pair_1,LogGPT,2,success,1,4,22,2,29,0,19146,1601,20747,29
spark,pair_4,LogGPT,1,success,1,0,3,0,4,0,1833,1405,3238,4
terminal,pair_4,LogGPT,1,success,1,0,2,0,3,0,1215,786,2001,3
neovim,pair_1,LogGPT,1,success,1,6,144,4,155,42,129279,113004,242283,155
open-webui,pair_3,LogGPT,2,success,1,0,10,153,164,0,178244,7548,185792,164
elasticsearch,pair_4,LogGPT,2,failed,0,0,0,0,0,0,0,0,0,0
ui,pair_1,LogGPT,1,success,1,0,5,0,6,8,2035,1454,3489,6
llama_index,pair_3,LogGPT,1,success,1,2,13,7,23,0,14423,12409,26832,23
bubbletea,pair_1,LogGPT,2,success,2,1,15,0,18,0,11437,993,12430,18
uv,pair_1,LogGPT,1,success,3,1,19,49,72,40,181254,25734,206988,72
mantine,pair_1,LogGPT,2,success,1,4,26,1,32,0,26543,1873,28416,32
code-server,pair_1,LogGPT,1,success,1,2,23,0,26,0,19045,17243,36288,26
LLMs-from-scratch,pair_1,LogGPT,1,success,1,1,17,0,19,0,10302,8605,18907,19
starship,pair_3,LogGPT,2,success,1,2,7,0,10,0,5233,667,5900,10
okhttp,pair_2,LogGPT,2,success,17,5,21,13,56,1,46510,4642,51152,56
llama_index,pair_1,LogGPT,1,success,2,0,34,1,37,1,26559,23826,50385,37
fabric,pair_2,LogGPT,2,success,2,1,27,5,35,0,29249,1722,30971,35
lossless-cut,pair_1,LogGPT,2,success,4,0,5,81,90,0,163815,4252,168067,90
godot,pair_3,LogGPT,1,success,4,1,10,4,19,1,12781,9262,22043,19
dubbo,pair_2,LogGPT,1,success,2,0,14,415,431,16,390623,358079,748702,431
cpython,pair_3,LogGPT,1,success,1,1,9,7,18,1,10468,9177,19645,18
stats,pair_1,LogGPT,1,success,1,1,21,0,23,0,11105,9070,20175,23
julia,pair_4,LogGPT,2,success,1,1,4,0,6,0,4748,434,5182,6
jan,pair_4,LogGPT,1,success,4,1,30,7,42,12,43953,24482,68435,42
flask,pair_3,LogGPT,1,success,8,0,14,257,279,27,536102,174850,710952,279
fabric,pair_1,LogGPT,1,success,1,0,4,0,5,111,1719,1240,2959,5
prettier,pair_4,LogGPT,1,success,1,1,28,0,30,3,17380,15149,32529,30
slate,pair_3,LogGPT,2,success,2,0,8,4,14,0,10898,716,11614,14
open-webui,pair_4,LogGPT,2,success,2,0,8,0,10,0,5055,690,5745,10
dify,pair_2,LogGPT,1,success,4,2,31,11,48,1,31884,27987,59871,48
dubbo,pair_2,LogGPT,2,success,4,0,14,429,447,0,420416,16960,437376,447
terminal,pair_2,LogGPT,2,success,1,0,2,0,3,0,1095,226,1321,3
hugo,pair_4,LogGPT,1,success,11,3,79,11,104,4,86634,77577,164211,104
okhttp,pair_1,LogGPT,1,success,8,1,23,26,58,11,44523,40555,85078,58
wtfpython,pair_3,LogGPT,2,success,1,1,6,0,8,0,3819,535,4354,8
vault,pair_3,LogGPT,1,success,1,1,2,0,4,0,1556,1019,2575,4
elasticsearch,pair_1,LogGPT,2,success,1,1,21,0,23,0,13741,1295,15036,23
lossless-cut,pair_4,LogGPT,2,success,4,0,5,81,90,0,163543,3962,167505,90
laravel,pair_3,LogGPT,2,success,2,1,22,0,25,0,21346,1226,22572,25
uv,pair_2,LogGPT,1,success,5,1,16,46,68,40,174281,23869,198150,68
vllm,pair_1,LogGPT,1,success,2,1,11,49,63,0,50404,44642,95046,63
pixijs,pair_4,LogGPT,2,success,2,1,9,0,12,0,5406,767,6173,12
vllm,pair_2,LogGPT,2,success,10,14,215,0,239,0,392760,11763,404523,239
slate,pair_2,LogGPT,2,success,2,0,8,3,13,0,10754,717,11471,13
ionic-framework,pair_4,LogGPT,1,success,3,0,8,101,112,2,97589,84884,182473,112
ColossalAI,pair_1,LogGPT,2,success,2,0,25,1,28,0,17541,1481,19022,28
commander.js,pair_1,LogGPT,2,success,1,3,11,1,16,0,8526,1067,9593,16
LLMs-from-scratch,pair_3,LogGPT,1,success,3,1,16,5,25,0,17302,14950,32252,25
n8n,pair_2,LogGPT,2,success,3,9,39,7,58,0,132479,3390,135869,58
llama_index,pair_3,LogGPT,2,success,2,1,14,6,23,0,14154,1137,15291,23
meilisearch,pair_4,LogGPT,1,success,3,4,37,44,88,43,75029,66432,141461,88
cypress,pair_4,LogGPT,2,success,1,0,8,0,9,0,3883,437,4320,9
godot,pair_4,LogGPT,2,success,5,0,11,2,18,0,10489,1207,11696,18
pandas,pair_3,LogGPT,1,success,1,7,124,0,132,23,116411,99494,215905,132
jan,pair_3,LogGPT,1,success,4,2,44,12,62,10,47875,34389,82264,62
vllm,pair_2,LogGPT,1,success,2,15,86,0,103,136,113447,72663,186110,103
retrofit,pair_1,LogGPT,2,success,2,0,19,1,22,0,14609,970,15579,22
youtube-dl,pair_2,LogGPT,2,success,5,6,28,8,47,0,34154,3111,37265,47
meilisearch,pair_4,LogGPT,2,success,3,4,42,82,131,0,132781,5726,138507,131
generative-ai-for-beginners,pair_2,LogGPT,2,success,3,0,4,7,14,0,15849,939,16788,14
mongoose,pair_2,LogGPT,2,success,11,1,10,146,168,0,274984,7532,282516,168
code-server,pair_2,LogGPT,1,success,1,1,27,0,29,0,20322,18405,38727,29
bruno,pair_1,LogGPT,2,success,2,5,18,0,25,0,15688,1603,17291,25
ollama,pair_1,LogGPT,1,success,3,1,5,2,11,0,6783,5917,12700,11
supabase,pair_3,LogGPT,1,success,1,2,15,0,18,1,11168,8655,19823,18
gpt4all,pair_3,LogGPT,1,success,1,0,8,0,9,1,5425,4758,10183,9
cypress,pair_2,LogGPT,1,success,1,0,8,0,9,0,3663,3314,6977,9
django,pair_4,LogGPT,1,success,1,1,9,0,11,2,6418,5690,12108,11
spring-boot,pair_2,LogGPT,1,success,2,1,25,1,29,0,19459,17139,36598,29
hugo,pair_2,LogGPT,2,success,7,123,79,8,217,0,191289,18534,209823,217
slate,pair_1,LogGPT,2,success,4,5,80,54,143,0,108185,7403,115588,143
pandas,pair_2,LogGPT,1,success,7,2,44,3,56,6,46982,41454,88436,56
laravel,pair_2,LogGPT,2,success,2,2,21,0,25,0,21511,1413,22924,25
fabric,pair_1,LogGPT,2,success,13,1,3,99,116,0,168471,6583,175054,116
fabric,pair_4,LogGPT,2,success,1,4,43,0,48,0,42019,2539,44558,48
generative-ai-for-beginners,pair_4,LogGPT,1,success,1,1,3,0,5,10,2240,1846,4086,5
styled-components,pair_1,LogGPT,2,success,1,1,9,0,11,0,6004,623,6627,11
godot,pair_3,LogGPT,2,success,5,1,10,4,20,0,14423,1458,15881,20
ColossalAI,pair_1,LogGPT,1,success,2,1,23,1,27,1,16168,13822,29990,27
mongoose,pair_4,LogGPT,2,success,1,2,7,0,10,0,4929,694,5623,10
spark,pair_1,LogGPT,1,success,1,0,3,0,4,0,1765,1347,3112,4
hugo,pair_2,LogGPT,1,success,3,71,123,5,202,15,165534,142611,308145,202
fuels-ts,pair_3,LogGPT,2,success,41,16,107,17,181,0,340167,14320,354487,181
vault,pair_2,LogGPT,1,success,1,0,3,0,4,0,1370,916,2286,4
netdata,pair_4,LogGPT,1,success,8,1,24,26,59,20,49119,36958,86077,59
htmx,pair_2,LogGPT,2,success,1,2,7,0,10,0,4767,688,5455,10
mongoose,pair_1,LogGPT,1,success,2,1,12,6,21,150,16987,9710,26697,21
PowerShell,pair_4,LogGPT,1,success,1,1,6,0,8,0,3632,2804,6436,8
bubbletea,pair_2,LogGPT,1,success,1,2,13,0,16,1,9887,8312,18199,16
gpt_academic,pair_1,LogGPT,2,success,10,5,28,14,57,0,122915,3739,126654,57
dify,pair_3,LogGPT,2,success,1,5,32,16,54,0,38300,2551,40851,54
retrofit,pair_4,LogGPT,2,success,12,3,18,356,389,0,310820,16481,327301,389
Ghost,pair_1,LogGPT,2,success,48,1,27,40,116,0,271862,10719,282581,116
ui,pair_2,LogGPT,2,success,7,0,5,90,102,0,145859,4617,150476,102
nvm,pair_1,LogGPT,1,success,1,1,4,0,6,2,3232,2761,5993,6
elasticsearch,pair_3,LogGPT,1,success,1,2,22,0,25,191,15702,11384,27086,25
stable-diffusion-webui,pair_4,LogGPT,2,success,1,1,8,0,10,0,4243,577,4820,10
vllm,pair_3,LogGPT,2,success,5,2,10,29,46,0,27665,2290,29955,46
markitdown,pair_2,LogGPT,2,success,8,1,8,1,18,0,13799,1798,15597,18
gpt_academic,pair_3,LogGPT,2,success,9,5,28,14,56,4,111717,3531,115248,56
spark,pair_2,LogGPT,2,success,1,0,3,0,4,0,1799,240,2039,4
retrofit,pair_4,LogGPT,1,success,8,1,16,360,385,4,304568,263284,567852,385
docling,pair_1,LogGPT,2,success,1,0,22,0,23,0,15578,943,16521,23
insomnia,pair_1,LogGPT,1,success,4,31,30,0,65,22,97238,47173,144411,65
starship,pair_3,LogGPT,1,success,1,1,8,0,10,0,5068,4340,9408,10
ink-kit,pair_2,LogGPT,2,success,1,1,15,0,17,0,9745,811,10556,17
ink-kit,pair_2,LogGPT,1,success,1,1,15,0,17,0,9660,8199,17859,17
uv,pair_1,LogGPT,2,success,9,3,24,76,112,0,295305,5731,301036,112
docling,pair_1,LogGPT,1,success,1,0,21,0,22,1,14581,11687,26268,22
dubbo,pair_1,LogGPT,2,success,10,2,13,294,319,0,294800,12948,307748,319
gpt_academic,pair_2,LogGPT,2,success,7,4,29,12,52,0,64914,3027,67941,52
bubbletea,pair_3,LogGPT,2,success,2,0,5,3,10,0,8432,653,9085,10
cpython,pair_2,LogGPT,1,success,3,2,8,6,19,1,11155,8745,19900,19
mongoose,pair_3,LogGPT,1,success,1,0,5,1,7,8,3316,2649,5965,7
duckdb,pair_1,LogGPT,1,success,18,6,61,655,740,539,932399,703150,1635549,740
lossless-cut,pair_3,LogGPT,1,success,1,0,5,1,7,83,4473,2198,6671,7
retrofit,pair_1,LogGPT,1,success,2,0,15,1,18,4,8864,7594,16458,18
julia,pair_4,LogGPT,1,success,1,0,4,0,5,1,3416,2039,5455,5
lossless-cut,pair_4,LogGPT,1,success,1,0,5,1,7,83,4695,2190,6885,7
commander.js,pair_3,LogGPT,2,success,1,1,7,0,9,0,4202,570,4772,9
gpt_academic,pair_4,LogGPT,2,success,9,3,30,10,52,0,64013,3348,67361,52
generative-ai-for-beginners,pair_4,LogGPT,2,success,2,0,4,9,15,0,18082,922,19004,15
bruno,pair_1,LogGPT,1,success,2,2,21,0,25,0,15670,12373,28043,25
dify,pair_1,LogGPT,2,success,1,1,8,0,10,0,4299,563,4862,10
wtfpython,pair_2,LogGPT,1,success,1,0,7,0,8,0,3575,3047,6622,8
spring-boot,pair_3,LogGPT,2,success,12,0,13,23,48,0,45247,3027,48274,48
retrofit,pair_3,LogGPT,2,success,16,4,17,362,399,0,319464,17358,336822,399
stats,pair_4,LogGPT,1,success,1,1,20,0,22,0,10963,8778,19741,22
terminal,pair_2,LogGPT,1,success,1,0,2,0,3,0,1109,812,1921,3
markitdown,pair_1,LogGPT,2,success,8,0,9,1,18,0,14356,1650,16006,18
cockroach,pair_2,LogGPT,1,success,1,1,9,9,20,1,11862,10625,22487,20
alpine,pair_1,LogGPT,2,success,1,0,5,9,15,0,17271,732,18003,15
flask,pair_4,LogGPT,2,success,7,3,11,155,176,3,158006,8984,166990,176
mongoose,pair_2,LogGPT,1,success,1,1,10,7,19,149,18833,8560,27393,19
pixijs,pair_2,LogGPT,2,success,1,1,6,0,8,0,27952,581,28533,8
LLMs-from-scratch,pair_1,LogGPT,2,success,1,1,17,0,19,0,9850,971,10821,19
duckdb,pair_3,LogGPT,2,success,2,2,18,1,23,0,13339,1281,14620,23
netdata,pair_2,LogGPT,1,success,8,7,46,33,94,35,68958,59218,128176,94
dubbo,pair_1,LogGPT,1,success,7,1,14,284,306,13,275247,251969,527216,306
cpython,pair_4,LogGPT,1,success,1,8,434,0,443,17,511474,398429,909903,443
ionic-framework,pair_1,LogGPT,1,success,58,0,8,8,74,8,65198,57621,122819,74
meilisearch,pair_3,LogGPT,1,success,8,3,38,12,61,40,51504,46314,97818,61
ColossalAI,pair_4,LogGPT,1,success,7,4,34,2,47,26,44529,31454,75983,47
spring-boot,pair_1,LogGPT,1,success,2,1,25,1,29,0,19395,17140,36535,29
Ghost,pair_2,LogGPT,1,success,3,1,12,12,28,12,28614,15554,44168,28
cockroach,pair_1,LogGPT,1,success,1,2,17,1,21,7,12794,11132,23926,21
styled-components,pair_1,LogGPT,1,success,1,1,8,0,10,1,4442,3511,7953,10
LLMs-from-scratch,pair_4,LogGPT,1,success,1,0,18,0,19,0,10220,8627,18847,19
grafana,pair_4,LogGPT,1,success,161,0,12,7,180,146,186211,153308,339519,180
generative-ai-for-beginners,pair_2,LogGPT,1,success,1,0,4,0,5,9,1863,1315,3178,5
spark,pair_3,LogGPT,2,success,1,0,3,0,4,0,1821,251,2072,4
gpt_academic,pair_4,LogGPT,1,success,5,3,30,7,45,7,44881,23771,68652,45
AdminLTE,pair_2,LogGPT,2,success,5,2,8,0,15,0,10092,1348,11440,15
fabric,pair_3,LogGPT,1,success,1,1,9,0,11,0,6602,5433,12035,11
stable-diffusion-webui,pair_2,LogGPT,1,success,1,1,8,0,10,0,4227,3544,7771,10
certbot,pair_3,LogGPT,2,success,1,0,7,0,8,0,4474,395,4869,8
flask,pair_3,LogGPT,2,success,13,2,12,279,306,3,727290,15737,743027,306
duckdb,pair_3,LogGPT,1,success,2,0,20,1,23,0,13700,11792,25492,23
nvm,pair_2,LogGPT,1,success,1,1,11,2,15,2,9941,8572,18513,15
cockroach,pair_2,LogGPT,2,success,1,1,9,10,21,0,13566,966,14532,21
meilisearch,pair_1,LogGPT,2,success,1,2,19,0,22,0,11398,1240,12638,22
supabase,pair_4,LogGPT,2,success,2,3,36,1,42,0,39399,2251,41650,42
laravel,pair_1,LogGPT,2,success,2,1,22,0,25,0,21402,1307,22709,25
hugo,pair_3,LogGPT,1,success,5,3,79,15,102,6,84890,75931,160821,102
terminal,pair_3,LogGPT,2,success,1,0,2,0,3,0,1017,240,1257,3
grafana,pair_3,LogGPT,2,success,8,3,10,1,22,0,28040,2238,30278,22
nvm,pair_3,LogGPT,1,success,1,2,3,0,6,2,3206,2613,5819,6
tailwindcss,pair_1,LogGPT,1,success,4,4,29,14,51,6,40913,36179,77092,51
AutoGPT,pair_1,LogGPT,1,success,3,1,8,0,12,10,290933,4356,295289,12
okhttp,pair_3,LogGPT,2,success,8,1,25,15,49,0,41720,2831,44551,49
nvm,pair_2,LogGPT,2,success,2,3,11,1,17,0,12833,1152,13985,17
stable-diffusion-webui,pair_1,LogGPT,1,success,1,1,8,0,10,0,4346,3643,7989,10
AutoGPT,pair_2,LogGPT,1,success,1,0,9,0,10,0,5150,4647,9797,10
supabase,pair_3,LogSage,default,success,1,0,0,0,1,0,18891,216,19107,1
stats,pair_3,LogSage,default,success,1,0,0,0,1,0,11813,187,12000,1
llama_index,pair_4,LogSage,default,success,1,0,0,0,1,0,18788,312,19100,1
gpt4all,pair_1,LogSage,default,success,1,0,0,0,1,0,14804,177,14981,1
stable-diffusion-webui,pair_4,LogSage,default,success,1,0,0,0,1,0,11607,196,11803,1
gpt_academic,pair_1,LogSage,default,success,1,0,0,0,1,0,6002,376,6378,1
spring-boot,pair_2,LogSage,default,success,1,0,0,0,1,0,16236,292,16528,1
nvm,pair_3,LogSage,default,success,1,0,0,0,1,0,11207,187,11394,1
uv,pair_2,LogSage,default,success,1,0,0,0,1,0,27222,298,27520,1
cypress,pair_4,LogSage,default,success,1,0,0,0,1,0,10125,211,10336,1
wtfpython,pair_1,LogSage,default,success,1,0,0,0,1,0,29651,387,30038,1
vllm,pair_2,LogSage,default,success,1,0,0,0,1,0,18231,395,18626,1
spark,pair_3,LogSage,default,success,1,0,0,0,1,0,6255,244,6499,1
bruno,pair_1,LogSage,default,success,1,0,0,0,1,0,25829,378,26207,1
markitdown,pair_1,LogSage,default,success,1,0,0,0,1,0,25264,445,25709,1
AdminLTE,pair_1,LogSage,default,success,1,0,0,0,1,0,28222,466,28688,1
django,pair_1,LogSage,default,success,1,0,0,0,1,0,22007,1000,23007,1
llama_index,pair_2,LogSage,default,success,1,0,0,0,1,0,25632,463,26095,1
meilisearch,pair_4,LogSage,default,success,1,0,0,0,1,0,13565,391,13956,1
duckdb,pair_4,LogSage,default,success,1,0,0,0,1,0,27570,231,27801,1
pandas,pair_2,LogSage,default,success,1,0,0,0,1,0,4377,427,4804,1
wtfpython,pair_4,LogSage,default,success,1,0,0,0,1,0,10367,226,10593,1
dify,pair_3,LogSage,default,success,0,1,0,0,2,1,11382,891,12273,2
open-webui,pair_1,LogSage,default,success,1,0,0,0,1,0,14395,323,14718,1
code-server,pair_2,LogSage,default,success,1,0,0,0,1,0,27922,232,28154,1
cpython,pair_1,LogSage,default,success,1,0,0,0,1,0,31176,927,32103,1
spring-boot,pair_1,LogSage,default,success,1,0,0,0,1,0,16221,210,16431,1
flask,pair_2,LogSage,default,success,1,0,0,0,1,0,26496,408,26904,1
hugo,pair_2,LogSage,default,success,1,0,0,0,1,0,6066,368,6434,1
spark,pair_4,LogSage,default,success,1,0,0,0,1,0,6255,210,6465,1
duckdb,pair_2,LogSage,default,success,1,0,0,0,1,0,31035,226,31261,1
gpt_academic,pair_2,LogSage,default,success,1,0,0,0,1,0,5897,247,6144,1
dubbo,pair_1,LogSage,default,success,1,0,0,0,1,0,20439,266,20705,1
laravel,pair_1,LogSage,default,success,1,0,0,0,1,0,23940,248,24188,1
ColossalAI,pair_1,LogSage,default,success,1,0,0,0,1,0,19444,207,19651,1
supabase,pair_4,LogSage,default,success,1,0,0,0,1,0,27912,231,28143,1
jan,pair_3,LogSage,default,success,1,0,0,0,1,0,7479,326,7805,1
playwright,pair_1,LogSage,default,success,1,0,0,0,1,0,15190,455,15645,1
nvm,pair_1,LogSage,default,success,1,0,0,0,1,0,11291,171,11462,1
PowerShell,pair_3,LogSage,default,success,1,0,0,0,1,0,14003,286,14289,1
laravel,pair_4,LogSage,default,success,1,0,0,0,1,0,23950,202,24152,1
certbot,pair_2,LogSage,default,success,1,0,0,0,1,0,5225,177,5402,1
slate,pair_4,LogSage,default,success,1,0,0,0,1,0,20012,206,20218,1
mongoose,pair_4,LogSage,default,success,1,0,0,0,1,0,12171,332,12503,1
stats,pair_1,LogSage,default,success,1,0,0,0,1,0,12477,216,12693,1
dify,pair_4,LogSage,default,success,1,0,0,0,1,0,25791,213,26004,1
code-server,pair_3,LogSage,default,success,1,0,0,0,1,0,27972,230,28202,1
cypress,pair_2,LogSage,default,success,1,0,0,0,1,0,10118,209,10327,1
ColossalAI,pair_2,LogSage,default,success,1,0,0,0,1,0,28866,544,29410,1
dubbo,pair_3,LogSage,default,success,1,0,0,0,1,0,29563,287,29850,1
n8n,pair_4,LogSage,default,success,1,0,0,0,1,0,27797,527,28324,1
lossless-cut,pair_3,LogSage,default,success,1,0,0,0,1,0,22485,278,22763,1
flask,pair_1,LogSage,default,success,1,0,0,0,1,0,21829,332,22161,1
prettier,pair_4,LogSage,default,success,1,0,0,0,1,0,26970,297,27267,1
flask,pair_3,LogSage,default,success,1,0,0,0,1,0,5925,257,6182,1
prettier,pair_2,LogSage,default,success,1,0,0,0,1,0,14820,233,15053,1
stats,pair_4,LogSage,default,success,1,0,0,0,1,0,11805,186,11991,1
fabric,pair_4,LogSage,default,success,1,0,0,0,1,0,27617,214,27831,1
styled-components,pair_1,LogSage,default,success,1,0,0,0,1,0,13250,164,13414,1
certbot,pair_3,LogSage,default,success,1,0,0,0,1,0,11037,217,11254,1
certbot,pair_4,LogSage,default,success,1,0,0,0,1,0,11035,207,11242,1
wtfpython,pair_3,LogSage,default,success,1,0,0,0,1,0,10362,235,10597,1
open-webui,pair_3,LogSage,default,success,1,0,0,0,1,0,12466,304,12770,1
insomnia,pair_1,LogSage,default,success,1,0,0,0,1,0,9484,392,9876,1
bubbletea,pair_3,LogSage,default,success,1,0,0,0,1,0,10984,342,11326,1
netdata,pair_4,LogSage,default,success,1,0,0,0,1,0,21785,297,22082,1
vllm,pair_4,LogSage,default,success,1,0,0,0,1,0,11864,352,12216,1
django,pair_4,LogSage,default,success,1,0,0,0,1,0,15887,235,16122,1
julia,pair_3,LogSage,default,success,1,0,0,0,1,0,12974,203,13177,1
okhttp,pair_3,LogSage,default,success,1,0,0,0,1,0,28212,259,28471,1
cockroach,pair_2,LogSage,default,success,1,0,0,0,1,0,24062,255,24317,1
supabase,pair_1,LogSage,default,success,1,0,0,0,1,0,19067,179,19246,1
godot,pair_2,LogSage,default,success,1,0,0,0,1,0,21128,203,21331,1
terminal,pair_4,LogSage,default,success,1,0,0,0,1,0,4861,183,5044,1
grafana,pair_3,LogSage,default,success,1,0,0,0,1,0,27293,871,28164,1
hugo,pair_1,LogSage,default,success,1,0,0,0,1,0,6075,348,6423,1
llama_index,pair_3,LogSage,default,success,1,0,0,0,1,0,26450,511,26961,1
open-webui,pair_2,LogSage,default,success,1,0,0,0,1,0,13734,342,14076,1
meilisearch,pair_1,LogSage,default,success,1,0,0,0,1,0,12907,262,13169,1
spring-boot,pair_3,LogSage,default,success,1,0,0,0,1,0,28158,646,28804,1
ionic-framework,pair_2,LogSage,default,success,1,0,0,0,1,0,4649,367,5016,1
fabric,pair_3,LogSage,default,success,1,0,0,0,1,0,9475,221,9696,1
markitdown,pair_2,LogSage,default,success,1,0,0,0,1,0,24832,464,25296,1
lossless-cut,pair_2,LogSage,default,success,1,0,0,0,1,0,22271,373,22644,1
youtube-dl,pair_2,LogSage,default,success,1,0,0,0,1,0,28061,269,28330,1
nvm,pair_4,LogSage,default,success,1,0,0,0,1,0,22645,213,22858,1
generative-ai-for-beginners,pair_1,LogSage,default,success,1,0,0,0,1,0,20406,393,20799,1
fabric,pair_2,LogSage,default,success,1,0,0,0,1,0,27751,327,28078,1
hugo,pair_3,LogSage,default,success,1,0,0,0,1,0,11246,574,11820,1
markitdown,pair_3,LogSage,default,success,1,0,0,0,1,0,13620,279,13899,1
meilisearch,pair_2,LogSage,default,success,1,0,0,0,1,0,13079,230,13309,1
gpt_academic,pair_3,LogSage,default,success,1,0,0,0,1,0,18002,410,18412,1
nvm,pair_2,LogSage,default,success,1,0,0,0,1,0,22750,244,22994,1
slate,pair_3,LogSage,default,success,1,0,0,0,1,0,20371,182,20553,1
pandas,pair_3,LogSage,default,success,1,0,0,0,1,0,20352,283,20635,1
mongoose,pair_1,LogSage,default,success,1,0,0,0,1,0,26899,505,27404,1
pandas,pair_4,LogSage,default,failed,0,0,0,0,0,0,0,0,0,0
godot,pair_1,LogSage,default,success,1,0,0,0,1,0,31808,497,32305,1
spark,pair_2,LogSage,default,success,1,0,0,0,1,0,6252,211,6463,1
grafana,pair_2,LogSage,default,success,1,0,0,0,1,0,29297,593,29890,1
RxJava,pair_1,LogSage,default,success,1,0,0,0,1,0,29533,299,29832,1
pixijs,pair_1,LogSage,default,success,1,0,0,0,1,0,17992,346,18338,1
n8n,pair_2,LogSage,default,success,1,0,0,0,1,0,16368,560,16928,1
PowerShell,pair_1,LogSage,default,success,1,0,0,0,1,0,14577,287,14864,1
django,pair_3,LogSage,default,success,1,0,0,0,1,0,12630,393,13023,1
gpt4all,pair_4,LogSage,default,success,1,0,0,0,1,0,14583,209,14792,1
lx-music-desktop,pair_1,LogSage,default,success,1,0,0,0,1,0,24438,269,24707,1
fuels-ts,pair_1,LogSage,default,success,1,0,0,0,1,0,13467,238,13705,1
duckdb,pair_1,LogSage,default,success,1,0,0,0,1,0,21588,727,22315,1
dify,pair_1,LogSage,default,success,1,0,0,0,1,0,11298,186,11484,1
htmx,pair_2,LogSage,default,success,1,0,0,0,1,0,11877,224,12101,1
ink-kit,pair_3,LogSage,default,success,1,0,0,0,1,0,13361,193,13554,1
tailwindcss,pair_1,LogSage,default,success,1,0,0,0,1,0,5615,229,5844,1
okhttp,pair_2,LogSage,default,success,1,0,0,0,1,0,11775,273,12048,1
mantine,pair_1,LogSage,default,success,1,0,0,0,1,0,27128,283,27411,1
slate,pair_1,LogSage,default,success,1,0,0,0,1,0,4900,222,5122,1
mongoose,pair_2,LogSage,default,success,1,0,0,0,1,0,26929,262,27191,1
dubbo,pair_4,LogSage,default,success,1,0,0,0,1,0,29255,250,29505,1
starship,pair_2,LogSage,default,success,1,0,0,0,1,0,12220,262,12482,1
grafana,pair_4,LogSage,default,success,1,0,0,0,1,0,27645,360,28005,1
PowerShell,pair_4,LogSage,default,success,1,0,0,0,1,0,9945,183,10128,1
mongoose,pair_3,LogSage,default,success,1,0,0,0,1,0,21985,276,22261,1
code-server,pair_1,LogSage,default,success,1,0,0,0,1,0,27962,230,28192,1
starship,pair_1,LogSage,default,success,1,0,0,0,1,0,12214,311,12525,1
ColossalAI,pair_4,LogSage,default,success,1,0,0,0,1,0,13556,254,13810,1
stats,pair_2,LogSage,default,success,1,0,0,0,1,0,12198,190,12388,1
uv,pair_3,LogSage,default,success,1,0,0,0,1,0,18778,258,19036,1
LLMs-from-scratch,pair_3,LogSage,default,success,1,0,0,0,1,0,25394,291,25685,1
AutoGPT,pair_3,LogSage,default,success,1,0,0,0,1,0,15224,205,15429,1
okhttp,pair_1,LogSage,default,success,1,0,0,0,1,0,12754,284,13038,1
retrofit,pair_1,LogSage,default,success,1,0,0,0,1,0,25639,313,25952,1
lossless-cut,pair_4,LogSage,default,success,1,0,0,0,1,0,24047,361,24408,1
n8n,pair_1,LogSage,default,success,1,0,0,0,1,0,27957,275,28232,1
cpython,pair_3,LogSage,default,success,1,0,0,0,1,0,25316,525,25841,1
pixijs,pair_2,LogSage,default,success,1,0,0,0,1,0,30858,240,31098,1
Ghost,pair_2,LogSage,default,success,1,0,0,0,1,0,6861,361,7222,1
generative-ai-for-beginners,pair_4,LogSage,default,success,1,0,0,0,1,0,21400,413,21813,1
ink-kit,pair_1,LogSage,default,success,1,0,0,0,1,0,19326,208,19534,1
jan,pair_1,LogSage,default,success,1,0,0,0,1,0,9142,326,9468,1
gpt4all,pair_3,LogSage,default,success,1,0,0,0,1,0,14785,205,14990,1
hugo,pair_4,LogSage,default,success,1,0,0,0,1,0,14979,719,15698,1
django,pair_2,LogSage,default,success,1,0,0,0,1,0,13416,439,13855,1
markitdown,pair_4,LogSage,default,success,1,0,0,0,1,0,27560,303,27863,1
AutoGPT,pair_4,LogSage,default,success,1,0,0,0,1,0,3413,133,3546,1
terraform,pair_2,LogSage,default,success,1,0,0,0,1,0,15996,222,16218,1
bubbletea,pair_2,LogSage,default,success,0,1,0,0,1,0,19989,259,20248,1
jan,pair_2,LogSage,default,success,1,0,0,0,1,0,8954,255,9209,1
insomnia,pair_3,LogSage,default,success,1,0,0,0,1,0,12700,340,13040,1
pixijs,pair_3,LogSage,default,success,1,0,0,0,1,0,13459,282,13741,1
ui,pair_1,LogSage,default,success,1,0,0,0,1,0,20992,236,21228,1
bubbletea,pair_4,LogSage,default,success,1,0,0,0,1,0,15834,365,16199,1
vault,pair_1,LogSage,default,success,1,0,0,0,1,0,14726,281,15007,1
laravel,pair_3,LogSage,default,success,1,0,0,0,1,0,23952,243,24195,1
gpt4all,pair_2,LogSage,default,success,1,0,0,0,1,0,14443,228,14671,1
insomnia,pair_2,LogSage,default,success,1,0,0,0,1,0,33509,324,33833,1
playwright,pair_2,LogSage,default,success,1,0,0,0,1,0,3974,244,4218,1
youtube-dl,pair_1,LogSage,default,success,1,0,0,0,1,0,14785,235,15020,1
LLMs-from-scratch,pair_1,LogSage,default,success,1,0,0,0,1,0,22948,250,23198,1
starship,pair_3,LogSage,default,success,1,0,0,0,1,0,12206,282,12488,1
vault,pair_2,LogSage,default,success,1,0,0,0,1,0,5070,149,5219,1
commander.js,pair_3,LogSage,default,success,1,0,0,0,1,0,10810,224,11034,1
elasticsearch,pair_3,LogSage,default,success,1,0,0,0,1,0,28363,362,28725,1
elasticsearch,pair_1,LogSage,default,success,1,0,0,0,1,0,11538,248,11786,1
pixijs,pair_4,LogSage,default,success,1,0,0,0,1,0,13194,261,13455,1
dubbo,pair_2,LogSage,default,success,1,0,0,0,1,0,29501,335,29836,1
vllm,pair_1,LogSage,default,success,0,0,0,1,1,0,3417,11,3428,1
stable-diffusion-webui,pair_1,LogSage,default,success,1,0,0,0,1,0,11028,270,11298,1
alpine,pair_2,LogSage,default,success,1,0,0,0,1,0,12867,229,13096,1
flask,pair_4,LogSage,default,success,1,0,0,0,1,0,27727,515,28242,1
retrofit,pair_2,LogSage,default,success,1,0,0,0,1,0,28888,303,29191,1
fabric,pair_1,LogSage,default,success,1,0,0,0,1,0,17204,252,17456,1
vault,pair_3,LogSage,default,success,1,0,0,0,1,0,5071,158,5229,1
julia,pair_2,LogSage,default,success,1,0,0,0,1,0,10241,203,10444,1
gpt_academic,pair_4,LogSage,default,success,1,0,0,0,1,0,5908,430,6338,1
llama_index,pair_1,LogSage,default,success,1,0,0,0,1,0,18958,249,19207,1
ui,pair_2,LogSage,default,success,1,0,0,0,1,0,19686,356,20042,1
docling,pair_1,LogSage,default,success,1,0,0,0,1,0,21722,248,21970,1
julia,pair_4,LogSage,default,success,1,0,0,0,1,0,9604,212,9816,1
AutoGPT,pair_1,LogSage,default,success,1,0,0,0,1,0,3415,212,3627,1
playwright,pair_4,LogSage,default,success,1,0,0,0,1,0,26256,216,26472,1
terraform,pair_3,LogSage,default,success,1,0,0,0,1,0,13185,240,13425,1
AutoGPT,pair_2,LogSage,default,success,1,0,0,0,1,0,12655,411,13066,1
ionic-framework,pair_3,LogSage,default,success,1,0,0,0,1,0,25482,420,25902,1
prettier,pair_3,LogSage,default,success,1,0,0,0,1,0,27180,615,27795,1
certbot,pair_1,LogSage,default,success,1,0,0,0,1,0,5226,177,5403,1
terminal,pair_1,LogSage,default,success,1,0,0,0,1,0,4861,195,5056,1
uv,pair_1,LogSage,default,success,1,0,0,0,1,0,17879,299,18178,1
netdata,pair_3,LogSage,default,success,1,0,0,0,1,0,32699,380,33079,1
pandas,pair_1,LogSage,default,success,1,0,0,0,1,0,14640,236,14876,1
alpine,pair_1,LogSage,default,success,1,0,0,0,1,0,20747,249,20996,1
elasticsearch,pair_2,LogSage,default,success,1,0,0,0,1,0,11536,286,11822,1
terraform,pair_1,LogSage,default,success,1,0,0,0,1,0,19552,529,20081,1
netdata,pair_2,LogSage,default,success,1,0,0,0,1,0,16944,265,17209,1
neovim,pair_1,LogSage,default,success,1,0,0,0,1,0,5763,194,5957,1
stable-diffusion-webui,pair_2,LogSage,default,success,1,0,0,0,1,0,11029,269,11298,1
cypress,pair_1,LogSage,default,success,1,0,0,0,1,0,10127,223,10350,1
starship,pair_4,LogSage,default,success,1,0,0,0,1,0,12203,270,12473,1
commander.js,pair_4,LogSage,default,success,1,0,0,0,1,0,11344,213,11557,1
prettier,pair_1,LogSage,default,success,1,0,0,0,1,0,13827,263,14090,1
cockroach,pair_3,LogSage,default,success,1,0,0,0,1,0,6735,226,6961,1
commander.js,pair_2,LogSage,default,success,1,0,0,0,1,0,11320,212,11532,1
supabase,pair_2,LogSage,default,success,1,0,0,0,1,0,27888,286,28174,1
ionic-framework,pair_1,LogSage,default,success,1,0,0,0,1,0,27412,355,27767,1
spring-boot,pair_4,LogSage,default,success,1,0,0,0,1,0,16180,251,16431,1
Ghost,pair_1,LogSage,default,success,1,0,0,0,1,0,26678,584,27262,1
terminal,pair_3,LogSage,default,success,1,0,0,0,1,0,4861,218,5079,1
retrofit,pair_4,LogSage,default,success,1,0,0,0,1,0,9195,338,9533,1
n8n,pair_3,LogSage,default,success,1,0,0,0,1,0,23818,462,24280,1
julia,pair_1,LogSage,default,success,1,0,0,0,1,0,12997,255,13252,1
LLMs-from-scratch,pair_4,LogSage,default,success,1,0,0,0,1,0,22940,242,23182,1
duckdb,pair_3,LogSage,default,success,1,0,0,0,1,0,23220,367,23587,1
ollama,pair_1,LogSage,default,success,1,0,0,0,1,0,15977,213,16190,1
fuels-ts,pair_3,LogSage,default,success,1,0,0,0,1,0,27331,667,27998,1
stable-diffusion-webui,pair_3,LogSage,default,success,1,0,0,0,1,0,11027,271,11298,1
jan,pair_4,LogSage,default,success,1,0,0,0,1,0,27788,272,28060,1
retrofit,pair_3,LogSage,default,success,1,0,0,0,1,0,14764,432,15196,1
generative-ai-for-beginners,pair_3,LogSage,default,success,1,0,0,0,1,0,22387,388,22775,1
ink-kit,pair_2,LogSage,default,success,1,0,0,0,1,0,19594,198,19792,1
terminal,pair_2,LogSage,default,success,1,0,0,0,1,0,4861,193,5054,1
htmx,pair_1,LogSage,default,success,1,0,0,0,1,0,19727,261,19988,1
fuels-ts,pair_2,LogSage,default,success,1,0,0,0,1,0,26698,427,27125,1
ionic-framework,pair_4,LogSage,default,success,1,0,0,0,1,0,19654,212,19866,1
dify,pair_2,LogSage,default,success,1,0,0,0,1,0,6705,309,7014,1
cypress,pair_3,LogSage,default,success,1,0,0,0,1,0,10125,214,10339,1
laravel,pair_2,LogSage,default,success,1,0,0,0,1,0,23954,194,24148,1
generative-ai-for-beginners,pair_2,LogSage,default,success,1,0,0,0,1,0,22227,358,22585,1
AdminLTE,pair_2,LogSage,default,success,1,0,0,0,1,0,16891,345,17236,1
bubbletea,pair_1,LogSage,default,success,0,1,0,0,1,0,20421,361,20782,1
cockroach,pair_1,LogSage,default,success,1,0,0,0,1,0,28176,213,28389,1
grafana,pair_1,LogSage,default,success,0,1,0,0,1,0,20784,430,21214,1
LLMs-from-scratch,pair_2,LogSage,default,success,1,0,0,0,1,0,24911,244,25155,1
commander.js,pair_1,LogSage,default,success,1,0,0,0,1,0,17919,178,18097,1
tailwindcss,pair_2,LogSage,default,success,1,0,0,0,1,0,6476,213,6689,1
wtfpython,pair_2,LogSage,default,success,1,0,0,0,1,0,10228,281,10509,1
cpython,pair_4,LogSage,default,success,1,0,0,0,1,0,31446,452,31898,1
godot,pair_4,LogSage,default,success,1,0,0,0,1,0,21337,290,21627,1
netdata,pair_1,LogSage,default,success,1,0,0,0,1,0,18728,391,19119,1
fzf,pair_1,LogSage,default,success,1,0,0,0,1,0,20335,203,20538,1
slate,pair_2,LogSage,default,success,1,0,0,0,1,0,19584,199,19783,1
godot,pair_3,LogSage,default,success,1,0,0,0,1,0,26399,352,26751,1
open-webui,pair_4,LogSage,default,success,1,0,0,0,1,0,12660,342,13002,1
lossless-cut,pair_1,LogSage,default,success,1,0,0,0,1,0,24082,326,24408,1
vllm,pair_3,LogSage,default,success,1,0,0,0,1,0,3419,211,3630,1
meilisearch,pair_3,LogSage,default,success,1,0,0,0,1,0,17640,667,18307,1
ColossalAI,pair_3,LogSage,default,success,1,0,0,0,1,0,28866,926,29792,1
cpython,pair_2,LogSage,default,success,1,0,0,0,1,0,25567,497,26064,1
playwright,pair_3,LogSage,default,success,0,0,0,1,1,0,28018,11,28029,1
elasticsearch,pair_4,LogSage,default,failed,0,0,0,0,0,0,0,0,0,0
spark,pair_1,LogSage,default,success,1,0,0,0,1,0,6248,227,6475,1
PowerShell,pair_2,LogSage,default,success,1,0,0,0,1,0,14299,329,14628,1
