project,case_id,method,prompt_type,status,true_positives,false_positives,true_negatives,false_negatives,success_count,failure_count,prompt_tokens,completion_tokens,total_tokens,query_count
llama_index,pair_3,LogPrompt,CoT,success,1,1,8,2,12,0,11192,6747,17939,12
ColossalAI,pair_3,LogPrompt,InContext,success,359,14,14,90,477,0,1199838,468078,1667916,477
julia,pair_2,LogPrompt,InContext,success,1,3,2,0,6,0,5774,2589,8363,6
godot,pair_4,LogPrompt,InContext,success,1,2,6,1,10,0,12181,5685,17866,10
htmx,pair_1,LogPrompt,CoT,success,1,0,4,2,7,0,11468,3565,15033,7
ollama,pair_1,LogPrompt,CoT,success,1,0,4,1,6,0,5563,3562,9125,6
terminal,pair_4,LogPrompt,CoT,success,1,0,2,0,3,0,906,782,1688,3
LLMs-from-scratch,pair_2,LogPrompt,InContext,success,1,3,5,0,9,0,12514,7120,19634,9
mongoose,pair_3,LogPrompt,InContext,success,1,1,3,2,7,0,15688,4328,20016,7
cypress,pair_2,LogPrompt,InContext,success,1,1,4,0,6,0,5825,3362,9187,6
pixijs,pair_2,LogPrompt,InContext,success,1,1,3,0,5,0,24383,2974,27357,5
ColossalAI,pair_1,LogPrompt,InContext,success,1,2,8,0,11,0,20393,9299,29692,11
prettier,pair_2,LogPrompt,CoT,success,1,2,6,0,9,0,5865,3256,9121,9
hugo,pair_4,LogPrompt,CoT,success,5,1,33,3,42,0,68482,32382,100864,42
grafana,pair_3,LogPrompt,InContext,success,3,3,3,0,9,0,24230,7226,31456,9
gpt_academic,pair_3,LogPrompt,InContext,success,1,7,9,6,23,0,90914,18123,109037,23
nvm,pair_1,LogPrompt,InContext,success,1,0,5,0,6,0,6958,3673,10631,6
neovim,pair_1,LogPrompt,InContext,success,2,16,46,1,65,0,178938,60276,239214,65
youtube-dl,pair_1,LogPrompt,InContext,success,1,4,6,0,11,0,15907,7118,23025,11
n8n,pair_1,LogPrompt,CoT,success,3,87,53,5,148,0,268582,139992,408574,148
fabric,pair_1,LogPrompt,CoT,success,3,0,4,31,38,0,133073,34482,167555,38
laravel,pair_2,LogPrompt,InContext,success,1,4,9,0,14,0,21155,8896,30051,14
tailwindcss,pair_2,LogPrompt,InContext,success,2,12,13,1,28,0,46425,21312,67737,28
pixijs,pair_4,LogPrompt,CoT,success,1,0,6,0,7,0,4530,3244,7774,7
bubbletea,pair_1,LogPrompt,InContext,success,1,5,4,0,10,0,12168,6637,18805,10
dubbo,pair_4,LogPrompt,InContext,success,44,6,4,86,140,0,380520,135973,516493,140
pandas,pair_1,LogPrompt,InContext,success,5,9,25,0,39,0,124207,34547,158754,39
spring-boot,pair_3,LogPrompt,InContext,success,6,3,5,5,19,0,40680,16039,56719,19
ionic-framework,pair_2,LogPrompt,InContext,success,4,1,4,2,11,0,20812,8378,29190,11
pixijs,pair_4,LogPrompt,InContext,success,1,2,4,0,7,0,7356,4348,11704,7
fzf,pair_1,LogPrompt,CoT,success,1,1,10,0,12,0,10826,6773,17599,12
laravel,pair_4,LogPrompt,InContext,success,1,4,9,0,14,0,21364,8679,30043,14
AutoGPT,pair_2,LogPrompt,CoT,success,1,0,6,0,7,0,4512,2689,7201,7
dify,pair_1,LogPrompt,CoT,success,1,0,6,0,7,0,3698,2460,6158,7
neovim,pair_1,LogPrompt,CoT,success,1,7,55,2,65,0,152900,58527,211427,65
hugo,pair_3,LogPrompt,InContext,success,5,9,25,3,42,0,86965,36978,123943,42
terminal,pair_4,LogPrompt,InContext,success,1,1,1,0,3,0,2189,791,2980,3
gpt4all,pair_4,LogPrompt,InContext,success,1,1,4,0,6,0,8539,3415,11954,6
playwright,pair_1,LogPrompt,InContext,success,5,0,5,13,23,0,75970,20344,96314,23
starship,pair_1,LogPrompt,CoT,success,1,2,4,0,7,0,4241,2843,7084,7
ColossalAI,pair_1,LogPrompt,CoT,success,1,0,10,0,11,0,16007,8343,24350,11
ionic-framework,pair_4,LogPrompt,InContext,success,5,0,5,27,37,0,81668,34510,116178,37
mongoose,pair_2,LogPrompt,CoT,success,29,0,7,19,55,0,184276,50009,234285,55
AutoGPT,pair_2,LogPrompt,InContext,success,1,2,3,0,6,1,6341,3348,9689,6
godot,pair_1,LogPrompt,InContext,success,1,14,64,0,79,0,398199,72833,471032,79
ui,pair_1,LogPrompt,CoT,success,1,0,4,2,7,0,12732,3484,16216,7
django,pair_1,LogPrompt,CoT,success,7,0,9,18,34,0,47901,29965,77866,34
stable-diffusion-webui,pair_4,LogPrompt,InContext,success,1,2,4,0,7,0,6914,4057,10971,7
open-webui,pair_4,LogPrompt,CoT,success,1,0,5,0,6,0,4146,3035,7181,6
okhttp,pair_1,LogPrompt,InContext,success,9,5,9,4,27,0,57503,21344,78847,27
PowerShell,pair_3,LogPrompt,InContext,success,1,0,4,1,6,0,7096,4023,11119,6
styled-components,pair_1,LogPrompt,InContext,success,1,4,2,0,7,0,7575,4223,11798,7
grafana,pair_4,LogPrompt,InContext,success,94,3,3,0,100,0,319591,98485,418076,100
htmx,pair_2,LogPrompt,InContext,success,1,3,3,0,7,0,6732,4634,11366,7
terraform,pair_3,LogPrompt,InContext,success,2,4,1,0,7,0,7380,4610,11990,7
generative-ai-for-beginners,pair_1,LogPrompt,CoT,success,0,0,4,3,7,0,12642,3879,16521,7
bruno,pair_1,LogPrompt,CoT,success,1,4,10,0,15,0,11694,6958,18652,15
ColossalAI,pair_2,LogPrompt,InContext,success,343,10,17,105,475,0,1195005,467768,1662773,475
gpt_academic,pair_4,LogPrompt,InContext,success,4,9,7,2,22,0,56664,16701,73365,22
cpython,pair_2,LogPrompt,InContext,success,2,3,3,1,9,0,13138,5912,19050,9
generative-ai-for-beginners,pair_2,LogPrompt,InContext,success,1,0,4,2,7,0,15248,3764,19012,7
retrofit,pair_2,LogPrompt,CoT,success,2,0,9,2,13,0,14482,6892,21374,13
playwright,pair_4,LogPrompt,CoT,success,1,0,5,3,9,0,10129,5607,15736,9
nvm,pair_1,LogPrompt,CoT,success,1,1,4,0,6,0,4568,2135,6703,6
retrofit,pair_4,LogPrompt,InContext,success,6,4,6,105,121,0,271221,117025,388246,121
julia,pair_4,LogPrompt,InContext,success,1,1,2,0,4,0,5437,1824,7261,4
AutoGPT,pair_1,LogPrompt,CoT,success,0,0,6,0,6,4,3887,2382,6269,6
terminal,pair_2,LogPrompt,CoT,success,1,0,2,0,3,0,906,534,1440,3
ionic-framework,pair_4,LogPrompt,CoT,success,1,0,5,31,37,0,67205,33656,100861,37
markitdown,pair_2,LogPrompt,CoT,success,3,0,6,0,9,0,10668,5247,15915,9
llama_index,pair_4,LogPrompt,InContext,success,1,9,7,0,17,0,28836,13047,41883,17
laravel,pair_1,LogPrompt,InContext,success,1,3,10,0,14,0,21510,8615,30125,14
open-webui,pair_3,LogPrompt,CoT,success,1,0,7,46,54,0,123032,48721,171753,54
slate,pair_4,LogPrompt,CoT,success,1,0,5,1,7,0,8149,3826,11975,7
cypress,pair_4,LogPrompt,CoT,success,1,0,5,0,6,0,3236,2178,5414,6
fuels-ts,pair_3,LogPrompt,CoT,success,10,7,35,8,60,0,239728,54214,293942,60
okhttp,pair_2,LogPrompt,CoT,success,3,1,12,6,22,0,33547,15225,48772,22
duckdb,pair_2,LogPrompt,InContext,success,50,4,7,83,144,0,1129175,141166,1270341,144
uv,pair_1,LogPrompt,InContext,success,7,4,9,19,39,0,218358,35543,253901,39
markitdown,pair_1,LogPrompt,InContext,success,3,1,5,0,9,0,14298,5896,20194,9
meilisearch,pair_3,LogPrompt,InContext,success,6,4,14,11,35,0,89641,31627,121268,35
julia,pair_2,LogPrompt,CoT,success,1,0,5,0,6,0,3300,1823,5123,6
supabase,pair_4,LogPrompt,CoT,success,1,0,15,0,16,0,27968,12252,40220,16
mongoose,pair_4,LogPrompt,CoT,success,1,0,6,0,7,0,4382,2720,7102,7
terraform,pair_1,LogPrompt,InContext,success,1,2,4,3,10,0,19256,7656,26912,10
terminal,pair_1,LogPrompt,InContext,success,1,1,1,0,3,0,2099,989,3088,3
n8n,pair_2,LogPrompt,CoT,success,1,4,17,2,24,0,90362,16891,107253,24
django,pair_4,LogPrompt,CoT,success,1,0,7,0,8,0,7748,3341,11089,8
netdata,pair_4,LogPrompt,CoT,success,6,0,10,10,26,0,62113,24115,86228,26
certbot,pair_3,LogPrompt,InContext,success,1,2,1,0,4,0,4959,2824,7783,4
vault,pair_3,LogPrompt,CoT,success,1,0,2,0,3,0,957,702,1659,3
markitdown,pair_3,LogPrompt,InContext,success,1,4,2,0,7,0,7802,4284,12086,7
code-server,pair_2,LogPrompt,InContext,success,1,7,6,0,14,0,20427,10343,30770,14
supabase,pair_2,LogPrompt,InContext,success,1,6,9,0,16,0,34427,13768,48195,16
fabric,pair_3,LogPrompt,InContext,success,1,1,5,0,7,0,8461,3873,12334,7
terminal,pair_1,LogPrompt,CoT,success,1,0,2,0,3,0,906,521,1427,3
htmx,pair_2,LogPrompt,CoT,success,1,0,6,0,7,0,4095,2770,6865,7
cypress,pair_4,LogPrompt,InContext,success,1,3,2,0,6,0,5695,3521,9216,6
ink-kit,pair_2,LogPrompt,InContext,success,1,3,5,0,9,0,10415,5338,15753,9
hugo,pair_2,LogPrompt,InContext,success,2,5,61,3,71,0,171584,67771,239355,71
prettier,pair_4,LogPrompt,CoT,success,1,3,20,0,24,0,17015,8240,25255,24
ui,pair_2,LogPrompt,CoT,success,1,0,4,28,33,0,114080,29942,144022,33
flask,pair_4,LogPrompt,InContext,success,12,4,4,36,56,1,130873,51846,182719,56
bubbletea,pair_3,LogPrompt,InContext,success,1,1,3,1,6,0,8965,2740,11705,6
cockroach,pair_1,LogPrompt,InContext,success,3,7,6,0,16,0,25515,9053,34568,16
nvm,pair_3,LogPrompt,InContext,success,1,2,3,0,6,0,6863,2844,9707,6
AutoGPT,pair_1,LogPrompt,InContext,success,0,1,5,0,6,4,6179,3279,9458,6
fabric,pair_2,LogPrompt,CoT,success,0,0,12,2,14,0,21146,10022,31168,14
cpython,pair_4,LogPrompt,InContext,success,2,28,118,0,148,0,488700,142029,630729,148
starship,pair_3,LogPrompt,CoT,success,1,2,4,0,7,0,4235,2793,7028,7
LLMs-from-scratch,pair_2,LogPrompt,CoT,success,1,0,8,0,9,0,8908,5776,14684,9
prettier,pair_4,LogPrompt,InContext,success,1,10,13,0,24,0,26747,13083,39830,24
vault,pair_2,LogPrompt,InContext,success,1,0,2,0,3,0,2251,1064,3315,3
certbot,pair_2,LogPrompt,CoT,success,1,0,2,0,3,0,995,760,1755,3
docling,pair_1,LogPrompt,CoT,success,1,0,12,0,13,0,11981,6328,18309,13
ColossalAI,pair_4,LogPrompt,InContext,success,2,10,17,1,30,0,91464,23757,115221,30
alpine,pair_2,LogPrompt,InContext,success,9,3,7,0,19,0,38830,16088,54918,19
fabric,pair_2,LogPrompt,InContext,success,0,3,9,2,14,0,26723,11317,38040,14
markitdown,pair_4,LogPrompt,CoT,success,8,0,6,5,19,0,28652,15073,43725,19
markitdown,pair_2,LogPrompt,InContext,success,3,2,4,0,9,0,14592,6710,21302,9
spring-boot,pair_1,LogPrompt,CoT,success,1,1,13,0,15,0,14023,7964,21987,15
fuels-ts,pair_1,LogPrompt,InContext,success,1,17,28,0,46,0,184694,41895,226589,46
wtfpython,pair_4,LogPrompt,InContext,success,1,1,4,0,6,0,5695,3561,9256,6
netdata,pair_2,LogPrompt,CoT,success,3,1,18,20,42,0,97901,38576,136477,42
vault,pair_2,LogPrompt,CoT,success,1,0,2,0,3,0,957,673,1630,3
AdminLTE,pair_1,LogPrompt,InContext,success,1,1,3,2,7,0,22322,4118,26440,7
elasticsearch,pair_2,LogPrompt,InContext,success,1,2,7,0,10,0,18904,7504,26408,10
lx-music-desktop,pair_1,LogPrompt,CoT,success,1,1,9,0,11,0,10405,5107,15512,11
pandas,pair_2,LogPrompt,CoT,success,4,0,19,0,23,0,54446,18621,73067,23
stable-diffusion-webui,pair_1,LogPrompt,CoT,success,1,0,6,0,7,0,3830,2407,6237,7
stable-diffusion-webui,pair_3,LogPrompt,CoT,success,1,0,6,0,7,0,3825,2388,6213,7
dify,pair_3,LogPrompt,CoT,success,1,3,15,5,24,0,27517,15464,42981,24
ink-kit,pair_3,LogPrompt,CoT,success,1,0,6,0,7,0,4530,3135,7665,7
cypress,pair_3,LogPrompt,CoT,success,1,0,5,0,6,0,3240,2210,5450,6
fzf,pair_1,LogPrompt,InContext,success,1,5,6,0,12,0,15668,8438,24106,12
uv,pair_2,LogPrompt,CoT,success,2,0,12,23,37,0,198966,32248,231214,37
elasticsearch,pair_1,LogPrompt,InContext,success,1,0,9,0,10,0,19547,7949,27496,10
llama_index,pair_1,LogPrompt,InContext,success,1,12,4,0,17,0,28610,13160,41770,17
terraform,pair_1,LogPrompt,CoT,success,1,0,6,3,10,0,15192,6729,21921,10
netdata,pair_3,LogPrompt,InContext,success,6,17,15,37,75,0,392794,73179,465973,75
llama_index,pair_1,LogPrompt,CoT,success,1,0,16,0,17,0,21780,11072,32852,17
commander.js,pair_1,LogPrompt,CoT,success,1,2,6,0,9,0,6271,4150,10421,9
spark,pair_1,LogPrompt,CoT,success,1,0,2,0,3,0,1251,1037,2288,3
playwright,pair_3,LogPrompt,InContext,success,2,2,7,1,12,0,20399,9274,29673,12
Ghost,pair_1,LogPrompt,CoT,success,15,1,11,12,39,0,186358,34904,221262,39
dify,pair_2,LogPrompt,CoT,success,2,1,15,3,21,0,23932,13993,37925,21
generative-ai-for-beginners,pair_4,LogPrompt,InContext,success,1,0,4,3,8,0,17742,4640,22382,8
slate,pair_1,LogPrompt,CoT,success,1,0,29,17,47,0,69857,42750,112607,47
grafana,pair_4,LogPrompt,CoT,success,94,1,5,0,100,0,279967,97267,377234,100
duckdb,pair_1,LogPrompt,CoT,success,23,14,106,246,389,0,1445986,383649,1829635,389
jan,pair_2,LogPrompt,CoT,success,2,0,19,6,27,0,49610,20547,70157,27
grafana,pair_1,LogPrompt,CoT,success,1,0,7,1,9,0,8736,3996,12732,9
tailwindcss,pair_2,LogPrompt,CoT,success,1,2,23,2,28,0,34858,17055,51913,28
wtfpython,pair_1,LogPrompt,CoT,success,12,0,5,0,17,0,76163,13774,89937,17
docling,pair_1,LogPrompt,InContext,success,1,5,7,0,13,0,17369,7158,24527,13
stable-diffusion-webui,pair_4,LogPrompt,CoT,success,1,0,6,0,7,0,4090,2636,6726,7
nvm,pair_4,LogPrompt,InContext,success,1,3,5,0,9,0,13803,6444,20247,9
Ghost,pair_1,LogPrompt,InContext,success,20,7,5,7,39,0,201987,36621,238608,39
supabase,pair_1,LogPrompt,CoT,success,1,1,9,0,11,0,10261,4946,15207,11
cockroach,pair_3,LogPrompt,InContext,success,1,1,1,0,3,0,2657,1919,4576,3
godot,pair_3,LogPrompt,InContext,success,2,6,2,1,11,0,16017,6146,22163,11
stats,pair_1,LogPrompt,CoT,success,1,0,9,0,10,0,12169,6085,18254,10
okhttp,pair_3,LogPrompt,InContext,success,4,4,10,3,21,0,38318,15955,54273,21
ollama,pair_1,LogPrompt,InContext,success,1,2,2,1,6,0,7894,4203,12097,6
retrofit,pair_1,LogPrompt,InContext,success,0,6,3,1,10,0,14845,6869,21714,10
gpt4all,pair_3,LogPrompt,InContext,success,1,1,4,0,6,0,8414,3696,12110,6
open-webui,pair_2,LogPrompt,InContext,success,1,5,2,0,8,0,8277,5347,13624,8
mongoose,pair_3,LogPrompt,CoT,success,0,0,4,3,7,0,12873,4091,16964,7
gpt_academic,pair_1,LogPrompt,InContext,success,6,8,8,2,24,0,99282,19263,118545,24
retrofit,pair_4,LogPrompt,CoT,success,9,0,10,102,121,0,223281,115643,338924,121
AdminLTE,pair_2,LogPrompt,InContext,success,2,2,4,0,8,0,11518,5965,17483,8
uv,pair_1,LogPrompt,CoT,success,6,0,13,20,39,0,202798,33663,236461,39
gpt4all,pair_4,LogPrompt,CoT,success,1,1,4,0,6,0,5865,2857,8722,6
prettier,pair_3,LogPrompt,CoT,success,156,2,5,28,191,0,354168,186782,540950,191
youtube-dl,pair_2,LogPrompt,InContext,success,3,8,8,1,20,0,34846,16439,51285,20
llama_index,pair_4,LogPrompt,CoT,success,1,0,16,0,17,0,21779,11208,32987,17
fabric,pair_1,LogPrompt,InContext,success,6,2,2,28,38,0,148766,34660,183426,38
cpython,pair_3,LogPrompt,CoT,success,2,0,6,1,9,0,9581,4984,14565,9
stats,pair_4,LogPrompt,InContext,success,1,1,8,0,10,0,15954,6831,22785,10
cypress,pair_1,LogPrompt,CoT,success,1,0,5,0,6,0,3238,2261,5499,6
retrofit,pair_1,LogPrompt,CoT,success,1,0,9,0,10,0,10636,5718,16354,10
commander.js,pair_2,LogPrompt,InContext,success,1,2,3,0,6,0,6058,3795,9853,6
gpt4all,pair_1,LogPrompt,InContext,success,1,2,3,0,6,0,8224,3490,11714,6
terraform,pair_3,LogPrompt,CoT,success,2,1,4,0,7,0,4636,3324,7960,7
vllm,pair_2,LogPrompt,InContext,success,2,12,63,1,78,0,330911,72356,403267,78
dify,pair_1,LogPrompt,InContext,success,1,2,4,0,7,0,6386,3732,10118,7
pandas,pair_3,LogPrompt,InContext,success,1,12,42,0,55,0,137332,48588,185920,55
pandas,pair_4,LogPrompt,CoT,failed,0,0,0,0,0,0,0,0,0,0
bubbletea,pair_4,LogPrompt,CoT,success,1,13,91,0,105,0,549707,102298,652005,105
julia,pair_3,LogPrompt,InContext,success,1,1,3,0,5,0,6432,3057,9489,5
julia,pair_3,LogPrompt,CoT,success,0,0,4,1,5,0,4397,2536,6933,5
starship,pair_4,LogPrompt,InContext,success,1,4,2,0,7,0,6921,3907,10828,7
flask,pair_3,LogPrompt,InContext,success,35,4,5,52,96,1,609285,90920,700205,96
supabase,pair_3,LogPrompt,InContext,success,1,5,5,0,11,0,14569,6405,20974,11
playwright,pair_1,LogPrompt,CoT,success,2,0,5,16,23,0,66386,19653,86039,23
slate,pair_3,LogPrompt,InContext,success,1,1,4,1,7,0,11044,5330,16374,7
generative-ai-for-beginners,pair_3,LogPrompt,CoT,success,2,0,4,2,8,0,15164,4169,19333,8
duckdb,pair_4,LogPrompt,CoT,success,0,11,108,1,120,0,400059,115419,515478,120
dubbo,pair_1,LogPrompt,InContext,success,35,4,5,56,100,0,268693,96470,365163,100
netdata,pair_3,LogPrompt,CoT,success,5,1,31,38,75,0,362976,71178,434154,75
cpython,pair_1,LogPrompt,CoT,success,20,8,42,21,91,0,294031,80759,374790,91
lossless-cut,pair_1,LogPrompt,InContext,success,5,2,2,21,30,0,138393,27229,165622,30
insomnia,pair_1,LogPrompt,InContext,success,1,22,8,0,31,0,105076,27487,132563,31
open-webui,pair_1,LogPrompt,InContext,success,1,2,5,0,8,0,8487,5985,14472,8
playwright,pair_3,LogPrompt,CoT,success,0,1,8,3,12,0,15408,7748,23156,12
meilisearch,pair_2,LogPrompt,CoT,success,1,0,8,0,9,0,14185,6146,20331,9
dubbo,pair_4,LogPrompt,CoT,success,23,0,10,107,140,0,324380,133811,458191,140
RxJava,pair_1,LogPrompt,InContext,success,5,1,7,1,14,0,24686,10025,34711,14
uv,pair_2,LogPrompt,InContext,success,6,7,5,19,37,0,214256,33812,248068,37
elasticsearch,pair_3,LogPrompt,InContext,success,2,5,67,0,74,0,290020,68435,358455,74
django,pair_4,LogPrompt,InContext,success,1,3,4,0,8,0,11200,5037,16237,8
alpine,pair_1,LogPrompt,CoT,success,0,0,4,3,7,0,13568,3791,17359,7
dify,pair_3,LogPrompt,InContext,success,3,10,8,3,24,0,37448,19228,56676,24
cockroach,pair_1,LogPrompt,CoT,success,1,0,13,2,16,0,18902,7911,26813,16
dify,pair_2,LogPrompt,InContext,success,3,7,9,2,21,0,32540,16706,49246,21
meilisearch,pair_4,LogPrompt,InContext,success,3,5,13,23,44,0,109200,40670,149870,44
gpt_academic,pair_1,LogPrompt,CoT,success,4,2,14,4,24,0,89704,15859,105563,24
code-server,pair_1,LogPrompt,InContext,success,1,9,4,0,14,0,19909,10363,30272,14
PowerShell,pair_2,LogPrompt,InContext,success,1,1,3,1,6,0,6997,4118,11115,6
stable-diffusion-webui,pair_1,LogPrompt,InContext,success,1,2,4,0,7,0,6871,3782,10653,7
gpt4all,pair_2,LogPrompt,CoT,success,1,0,5,0,6,0,5767,2910,8677,6
ui,pair_1,LogPrompt,InContext,success,1,1,3,2,7,0,15594,4115,19709,7
flask,pair_1,LogPrompt,InContext,success,2,4,4,1,11,0,13463,5680,19143,11
django,pair_3,LogPrompt,InContext,success,1,1,3,0,5,0,5844,3705,9549,5
wtfpython,pair_2,LogPrompt,CoT,success,1,0,5,0,6,0,3290,2108,5398,6
PowerShell,pair_3,LogPrompt,CoT,success,1,0,4,1,6,0,4456,3041,7497,6
grafana,pair_1,LogPrompt,InContext,success,1,5,2,1,9,0,12527,4819,17346,9
certbot,pair_4,LogPrompt,InContext,success,1,1,2,0,4,0,4907,2953,7860,4
django,pair_2,LogPrompt,InContext,success,1,1,3,0,5,0,6409,3257,9666,5
slate,pair_1,LogPrompt,InContext,success,12,10,19,6,47,0,88690,43642,132332,47
commander.js,pair_3,LogPrompt,CoT,success,1,1,4,0,6,0,3486,2374,5860,6
spark,pair_2,LogPrompt,InContext,success,1,0,2,0,3,0,2384,1634,4018,3
code-server,pair_1,LogPrompt,CoT,success,1,3,10,0,14,0,14249,8109,22358,14
certbot,pair_1,LogPrompt,CoT,success,1,0,2,0,3,0,996,683,1679,3
code-server,pair_3,LogPrompt,CoT,success,1,3,10,0,14,0,14435,8535,22970,14
ionic-framework,pair_2,LogPrompt,CoT,success,4,0,5,2,11,0,16394,7625,24019,11
n8n,pair_4,LogPrompt,CoT,success,34,0,13,12,59,0,93496,51323,144819,59
fuels-ts,pair_1,LogPrompt,CoT,success,1,2,43,0,46,0,165974,39797,205771,46
fabric,pair_4,LogPrompt,InContext,success,1,8,14,0,23,0,40225,15522,55747,23
prettier,pair_1,LogPrompt,InContext,success,1,3,4,0,8,0,8477,4713,13190,8
generative-ai-for-beginners,pair_4,LogPrompt,CoT,success,1,0,4,3,8,0,14536,4258,18794,8
supabase,pair_3,LogPrompt,CoT,success,1,1,9,0,11,0,10182,4996,15178,11
flask,pair_4,LogPrompt,CoT,success,3,0,8,45,56,1,108511,50938,159449,56
mongoose,pair_1,LogPrompt,CoT,success,31,1,8,17,57,0,184970,50581,235551,57
godot,pair_3,LogPrompt,CoT,success,2,0,8,1,11,0,11177,5254,16431,11
duckdb,pair_3,LogPrompt,InContext,success,1,3,7,0,11,0,14870,8413,23283,11
stats,pair_3,LogPrompt,InContext,success,1,3,6,0,10,0,15881,6802,22683,10
styled-components,pair_1,LogPrompt,CoT,success,1,2,4,0,7,0,4769,2726,7495,7
lossless-cut,pair_1,LogPrompt,CoT,success,1,0,4,25,30,0,126296,26354,152650,30
htmx,pair_1,LogPrompt,InContext,success,2,0,4,1,7,0,14350,4331,18681,7
supabase,pair_2,LogPrompt,CoT,success,1,0,15,0,16,0,27994,12298,40292,16
pixijs,pair_1,LogPrompt,CoT,success,1,0,6,1,8,0,6351,4091,10442,8
spark,pair_4,LogPrompt,InContext,success,1,1,1,0,3,0,2345,1490,3835,3
generative-ai-for-beginners,pair_2,LogPrompt,CoT,success,0,0,4,3,7,0,12512,3637,16149,7
gpt_academic,pair_2,LogPrompt,InContext,success,3,9,7,3,22,0,56898,16962,73860,22
gpt_academic,pair_4,LogPrompt,CoT,success,3,2,14,3,22,0,47602,14486,62088,22
markitdown,pair_4,LogPrompt,InContext,success,7,1,5,6,19,0,36119,16212,52331,19
meilisearch,pair_1,LogPrompt,CoT,success,1,0,8,0,9,0,12036,6169,18205,9
okhttp,pair_2,LogPrompt,InContext,success,5,5,8,4,22,0,42454,17566,60020,22
cpython,pair_3,LogPrompt,InContext,success,0,2,4,3,9,0,13184,5956,19140,9
jan,pair_3,LogPrompt,CoT,success,3,0,19,5,27,0,50307,21382,71689,27
gpt4all,pair_3,LogPrompt,CoT,success,1,1,4,0,6,0,5960,2905,8865,6
certbot,pair_1,LogPrompt,InContext,success,1,2,0,0,3,0,2294,1343,3637,3
llama_index,pair_3,LogPrompt,InContext,success,3,5,4,0,12,0,15999,8111,24110,12
starship,pair_4,LogPrompt,CoT,success,1,1,5,0,7,0,4235,2846,7081,7
tailwindcss,pair_1,LogPrompt,InContext,success,4,8,13,2,27,0,47535,21471,69006,27
julia,pair_4,LogPrompt,CoT,success,1,0,3,0,4,0,3899,1517,5416,4
laravel,pair_3,LogPrompt,InContext,success,1,4,9,0,14,0,20911,9113,30024,14
godot,pair_1,LogPrompt,CoT,success,1,9,69,0,79,0,365583,69323,434906,79
stats,pair_2,LogPrompt,CoT,success,1,0,9,0,10,0,11993,6140,18133,10
ink-kit,pair_3,LogPrompt,InContext,success,1,0,6,0,7,0,7296,3438,10734,7
vllm,pair_1,LogPrompt,InContext,success,2,5,4,14,25,0,43802,19489,63291,25
terminal,pair_3,LogPrompt,InContext,success,1,2,0,0,3,0,2192,1082,3274,3
grafana,pair_3,LogPrompt,CoT,success,3,1,5,0,9,0,20511,6232,26743,9
jan,pair_1,LogPrompt,CoT,success,3,0,19,5,27,0,49607,20524,70131,27
netdata,pair_4,LogPrompt,InContext,success,4,1,9,12,26,0,72000,24591,96591,26
dubbo,pair_1,LogPrompt,CoT,success,8,1,8,83,100,0,227826,94854,322680,100
flask,pair_3,LogPrompt,CoT,success,1,0,9,86,96,1,570402,90250,660652,96
cockroach,pair_2,LogPrompt,InContext,success,1,4,4,3,12,0,15623,5846,21469,12
meilisearch,pair_2,LogPrompt,InContext,success,1,1,7,0,9,0,17736,7278,25014,9
playwright,pair_2,LogPrompt,InContext,success,1,5,17,0,23,0,57873,19895,77768,23
jan,pair_2,LogPrompt,InContext,success,4,7,12,4,27,0,60464,22572,83036,27
insomnia,pair_2,LogPrompt,CoT,success,1,11,20,0,32,0,93247,26388,119635,32
lossless-cut,pair_4,LogPrompt,CoT,success,2,0,4,24,30,0,126339,26829,153168,30
pandas,pair_3,LogPrompt,CoT,success,1,2,52,0,55,0,115475,46092,161567,55
pandas,pair_4,LogPrompt,InContext,failed,0,0,0,0,0,0,0,0,0,0
starship,pair_2,LogPrompt,CoT,success,1,2,4,0,7,0,4247,2820,7067,7
AutoGPT,pair_3,LogPrompt,InContext,success,0,2,4,1,7,0,8608,4671,13279,7
vllm,pair_3,LogPrompt,InContext,success,2,3,6,8,19,0,28372,13870,42242,19
vault,pair_1,LogPrompt,InContext,success,0,12,24,1,37,0,88553,35407,123960,37
open-webui,pair_4,LogPrompt,InContext,success,1,0,5,0,6,0,6573,3666,10239,6
n8n,pair_3,LogPrompt,CoT,success,1,4,17,2,24,0,91771,17355,109126,24
cypress,pair_1,LogPrompt,InContext,success,1,1,4,0,6,0,5815,3290,9105,6
retrofit,pair_3,LogPrompt,CoT,success,12,0,10,102,124,0,230190,119058,349248,124
starship,pair_2,LogPrompt,InContext,success,1,3,3,0,7,0,7159,4422,11581,7
hugo,pair_1,LogPrompt,InContext,success,3,4,62,2,71,0,171141,67785,238926,71
certbot,pair_4,LogPrompt,CoT,success,1,0,3,0,4,0,3184,2407,5591,4
ColossalAI,pair_2,LogPrompt,CoT,success,409,3,24,39,475,0,1006228,466124,1472352,475
playwright,pair_4,LogPrompt,InContext,success,2,0,5,2,9,0,13822,6137,19959,9
laravel,pair_1,LogPrompt,CoT,success,1,2,11,0,14,0,15710,6912,22622,14
fabric,pair_3,LogPrompt,CoT,success,1,0,6,0,7,0,5578,3282,8860,7
uv,pair_3,LogPrompt,InContext,success,8,5,7,17,37,0,210838,33863,244701,37
youtube-dl,pair_1,LogPrompt,CoT,success,1,0,10,0,11,0,11588,5881,17469,11
gpt_academic,pair_2,LogPrompt,CoT,success,2,2,14,4,22,0,47774,14682,62456,22
PowerShell,pair_1,LogPrompt,InContext,success,1,1,3,1,6,0,6890,4061,10951,6
generative-ai-for-beginners,pair_1,LogPrompt,InContext,success,2,0,4,1,7,0,15432,3915,19347,7
fuels-ts,pair_2,LogPrompt,InContext,success,1,6,8,0,15,0,22385,10008,32393,15
n8n,pair_1,LogPrompt,InContext,success,2,61,79,6,148,0,327691,142471,470162,148
pixijs,pair_2,LogPrompt,CoT,success,1,0,4,0,5,0,22450,2218,24668,5
hugo,pair_4,LogPrompt,InContext,success,6,10,24,2,42,0,84955,37137,122092,42
netdata,pair_1,LogPrompt,InContext,success,12,7,6,11,36,0,106365,33941,140306,36
spring-boot,pair_3,LogPrompt,CoT,success,4,2,6,7,19,0,33236,14414,47650,19
insomnia,pair_3,LogPrompt,CoT,success,1,3,8,0,12,0,36707,6578,43285,12
duckdb,pair_4,LogPrompt,InContext,success,1,5,114,0,120,0,448209,116819,565028,120
mantine,pair_1,LogPrompt,CoT,success,1,1,12,0,14,0,22983,9449,32432,14
dubbo,pair_3,LogPrompt,CoT,success,20,0,10,110,140,0,324377,134247,458624,140
dify,pair_4,LogPrompt,InContext,success,1,5,8,0,14,0,20160,9974,30134,14
n8n,pair_2,LogPrompt,InContext,success,2,11,10,1,24,0,100303,19071,119374,24
lossless-cut,pair_2,LogPrompt,InContext,success,5,2,2,21,30,0,138597,26950,165547,30
LLMs-from-scratch,pair_1,LogPrompt,InContext,success,1,3,5,0,9,0,11918,6466,18384,9
lossless-cut,pair_4,LogPrompt,InContext,success,3,0,4,23,30,0,138776,26818,165594,30
AdminLTE,pair_2,LogPrompt,CoT,success,2,1,5,0,8,0,8016,4353,12369,8
vllm,pair_4,LogPrompt,CoT,success,5,0,9,22,36,0,61752,28971,90723,36
jan,pair_3,LogPrompt,InContext,success,3,4,15,5,27,0,60761,22675,83436,27
wtfpython,pair_3,LogPrompt,InContext,success,1,1,4,0,6,0,5709,3209,8918,6
slate,pair_3,LogPrompt,CoT,success,1,0,5,1,7,0,8223,4039,12262,7
AutoGPT,pair_4,LogPrompt,InContext,success,0,1,5,0,6,4,6592,3982,10574,6
hugo,pair_2,LogPrompt,CoT,success,2,1,65,3,71,0,142682,64854,207536,71
stable-diffusion-webui,pair_2,LogPrompt,CoT,success,1,0,6,0,7,0,3827,2369,6196,7
bubbletea,pair_1,LogPrompt,CoT,success,1,0,9,0,10,0,8390,4759,13149,10
tailwindcss,pair_1,LogPrompt,CoT,success,2,3,18,4,27,0,36700,17446,54146,27
terraform,pair_2,LogPrompt,InContext,success,3,0,6,1,10,0,17846,7401,25247,10
hugo,pair_1,LogPrompt,CoT,success,2,1,65,3,71,0,142374,64582,206956,71
stats,pair_3,LogPrompt,CoT,success,1,0,9,0,10,0,11842,6110,17952,10
cpython,pair_2,LogPrompt,CoT,success,0,0,6,3,9,0,9720,5032,14752,9
mongoose,pair_2,LogPrompt,InContext,success,29,1,6,19,55,0,206557,51790,258347,55
terminal,pair_3,LogPrompt,CoT,success,1,0,2,0,3,0,906,533,1439,3
lossless-cut,pair_3,LogPrompt,CoT,success,1,0,4,25,30,0,126357,26464,152821,30
lossless-cut,pair_2,LogPrompt,CoT,success,1,0,4,25,30,0,126138,26479,152617,30
elasticsearch,pair_2,LogPrompt,CoT,success,1,0,9,0,10,0,14988,6439,21427,10
mongoose,pair_1,LogPrompt,InContext,success,19,5,4,29,57,0,207715,52676,260391,57
ColossalAI,pair_4,LogPrompt,CoT,success,3,3,24,0,30,0,79062,21523,100585,30
alpine,pair_2,LogPrompt,CoT,success,9,0,10,0,19,0,31628,14300,45928,19
spring-boot,pair_4,LogPrompt,CoT,success,1,1,13,0,15,0,13995,7870,21865,15
vllm,pair_2,LogPrompt,CoT,success,2,5,70,1,78,0,299898,71017,370915,78
elasticsearch,pair_1,LogPrompt,CoT,success,1,0,9,0,10,0,15272,6545,21817,10
slate,pair_2,LogPrompt,InContext,success,2,0,5,0,7,0,10645,5113,15758,7
godot,pair_4,LogPrompt,CoT,success,1,0,8,1,10,0,8087,4427,12514,10
LLMs-from-scratch,pair_4,LogPrompt,InContext,success,1,3,5,0,9,0,11210,6185,17395,9
nvm,pair_2,LogPrompt,InContext,success,1,4,4,0,9,0,13780,6546,20326,9
nvm,pair_4,LogPrompt,CoT,success,1,1,7,0,9,0,10179,5019,15198,9
cockroach,pair_2,LogPrompt,CoT,success,0,0,8,4,12,0,11054,5013,16067,12
uv,pair_3,LogPrompt,CoT,success,4,0,12,21,37,0,195484,31877,227361,37
pixijs,pair_1,LogPrompt,InContext,success,1,3,3,1,8,0,9379,5085,14464,8
flask,pair_1,LogPrompt,CoT,success,2,0,8,1,11,0,9059,4266,13325,11
ink-kit,pair_2,LogPrompt,CoT,success,1,0,8,0,9,0,7105,4624,11729,9
netdata,pair_2,LogPrompt,InContext,success,6,6,13,17,42,0,114602,39732,154334,42
julia,pair_1,LogPrompt,CoT,success,1,0,4,0,5,0,4398,2475,6873,5
spark,pair_3,LogPrompt,InContext,success,0,0,2,1,3,0,2355,2055,4410,3
meilisearch,pair_1,LogPrompt,InContext,success,1,1,7,0,9,0,15499,7265,22764,9
code-server,pair_2,LogPrompt,CoT,success,1,2,11,0,14,0,14963,9191,24154,14
flask,pair_2,LogPrompt,InContext,success,2,2,5,1,10,0,14961,5849,20810,10
stable-diffusion-webui,pair_3,LogPrompt,InContext,success,1,3,3,0,7,0,6481,4174,10655,7
pixijs,pair_3,LogPrompt,CoT,success,1,0,6,0,7,0,4707,3107,7814,7
vault,pair_1,LogPrompt,CoT,success,0,2,34,1,37,0,73814,34789,108603,37
laravel,pair_3,LogPrompt,CoT,success,1,1,12,0,14,0,15714,6949,22663,14
ink-kit,pair_1,LogPrompt,CoT,success,1,0,8,0,9,0,6940,4452,11392,9
commander.js,pair_1,LogPrompt,InContext,success,1,3,5,0,9,0,9924,6300,16224,9
gpt4all,pair_1,LogPrompt,CoT,success,1,1,4,0,6,0,5996,2901,8897,6
jan,pair_4,LogPrompt,CoT,success,3,0,14,4,21,0,52561,15746,68307,21
flask,pair_2,LogPrompt,CoT,success,1,0,7,2,10,0,10676,5120,15796,10
stats,pair_4,LogPrompt,CoT,success,1,0,9,0,10,0,11799,6130,17929,10
fuels-ts,pair_3,LogPrompt,InContext,success,15,25,17,3,60,0,263661,55646,319307,60
godot,pair_2,LogPrompt,CoT,success,0,0,8,2,10,0,7948,4400,12348,10
ui,pair_2,LogPrompt,InContext,success,4,2,2,25,33,0,126781,30334,157115,33
julia,pair_1,LogPrompt,InContext,success,0,1,3,1,5,0,6522,3181,9703,5
open-webui,pair_2,LogPrompt,CoT,success,1,0,7,0,8,0,5166,3292,8458,8
retrofit,pair_3,LogPrompt,InContext,success,10,1,9,104,124,0,280779,120530,401309,124
LLMs-from-scratch,pair_1,LogPrompt,CoT,success,1,0,8,0,9,0,7958,5137,13095,9
commander.js,pair_3,LogPrompt,InContext,success,1,2,3,0,6,0,6165,3421,9586,6
cpython,pair_1,LogPrompt,InContext,success,17,22,28,24,91,0,330686,84564,415250,91
retrofit,pair_2,LogPrompt,InContext,success,3,6,3,1,13,0,19435,8443,27878,13
stable-diffusion-webui,pair_2,LogPrompt,InContext,success,1,1,5,0,7,0,6810,3674,10484,7
laravel,pair_4,LogPrompt,CoT,success,1,1,12,0,14,0,15708,7414,23122,14
Ghost,pair_2,LogPrompt,CoT,success,1,0,7,7,15,0,36861,11732,48593,15
spring-boot,pair_2,LogPrompt,CoT,success,1,1,13,0,15,0,14029,7929,21958,15
spring-boot,pair_1,LogPrompt,InContext,success,1,8,6,0,15,0,19799,10218,30017,15
certbot,pair_2,LogPrompt,InContext,success,1,2,0,0,3,0,2204,1194,3398,3
cypress,pair_3,LogPrompt,InContext,success,1,1,4,0,6,0,5366,3611,8977,6
playwright,pair_2,LogPrompt,CoT,success,1,1,21,0,23,0,48616,17876,66492,23
insomnia,pair_1,LogPrompt,CoT,success,1,9,21,0,31,0,92402,24857,117259,31
okhttp,pair_1,LogPrompt,CoT,success,5,1,13,8,27,0,46243,19781,66024,27
RxJava,pair_1,LogPrompt,CoT,success,4,0,8,2,14,0,18828,8593,27421,14
duckdb,pair_3,LogPrompt,CoT,success,1,1,9,0,11,0,10417,6831,17248,11
wtfpython,pair_3,LogPrompt,CoT,success,1,0,5,0,6,0,3367,2271,5638,6
vllm,pair_4,LogPrompt,InContext,success,6,3,6,21,36,0,76321,30327,106648,36
stats,pair_2,LogPrompt,InContext,success,1,3,6,0,10,0,15888,7232,23120,10
fabric,pair_4,LogPrompt,CoT,success,1,1,21,0,23,0,30697,13321,44018,23
hugo,pair_3,LogPrompt,CoT,success,4,3,31,4,42,0,69981,32609,102590,42
n8n,pair_3,LogPrompt,InContext,success,2,8,13,1,24,0,101002,19595,120597,24
terraform,pair_2,LogPrompt,CoT,success,2,0,6,2,10,0,13954,6439,20393,10
certbot,pair_3,LogPrompt,CoT,success,1,0,3,0,4,0,3191,2360,5551,4
starship,pair_1,LogPrompt,InContext,success,1,3,3,0,7,0,7123,4265,11388,7
PowerShell,pair_1,LogPrompt,CoT,success,1,0,4,1,6,0,4627,3047,7674,6
spring-boot,pair_4,LogPrompt,InContext,success,1,6,8,0,15,0,19941,10159,30100,15
starship,pair_3,LogPrompt,InContext,success,0,3,3,1,7,0,7084,4541,11625,7
mantine,pair_1,LogPrompt,InContext,success,1,4,9,0,14,0,28738,11313,40051,14
AutoGPT,pair_4,LogPrompt,CoT,success,0,0,6,0,6,4,3891,2430,6321,6
slate,pair_4,LogPrompt,InContext,success,1,1,4,1,7,0,10795,4971,15766,7
nvm,pair_3,LogPrompt,CoT,success,1,1,4,0,6,0,4516,2107,6623,6
bubbletea,pair_3,LogPrompt,CoT,success,2,0,4,0,6,0,6541,2189,8730,6
youtube-dl,pair_2,LogPrompt,CoT,success,3,2,14,1,20,0,27202,13399,40601,20
PowerShell,pair_4,LogPrompt,InContext,success,1,1,3,0,5,0,4929,3153,8082,5
spring-boot,pair_2,LogPrompt,InContext,success,0,6,8,1,15,0,20290,9543,29833,15
prettier,pair_1,LogPrompt,CoT,success,1,0,7,0,8,0,5301,2868,8169,8
elasticsearch,pair_4,LogPrompt,InContext,failed,0,0,0,0,0,0,0,0,0,0
slate,pair_2,LogPrompt,CoT,success,1,0,5,1,7,0,7836,3826,11662,7
bubbletea,pair_2,LogPrompt,CoT,success,1,1,8,0,10,0,8245,4538,12783,10
laravel,pair_2,LogPrompt,CoT,success,1,2,11,0,14,0,15709,7001,22710,14
ColossalAI,pair_3,LogPrompt,CoT,success,399,2,26,50,477,0,1009615,464715,1474330,477
vllm,pair_1,LogPrompt,CoT,success,2,0,9,14,25,0,33713,17918,51631,25
wtfpython,pair_4,LogPrompt,CoT,success,1,0,5,0,6,0,3368,2040,5408,6
cockroach,pair_3,LogPrompt,CoT,success,1,0,2,0,3,0,1446,1297,2743,3
dubbo,pair_3,LogPrompt,InContext,success,37,2,8,93,140,0,381252,136426,517678,140
grafana,pair_2,LogPrompt,CoT,success,203,1,33,248,485,0,1255857,480826,1736683,485
ionic-framework,pair_3,LogPrompt,CoT,success,10,0,5,1,16,0,27979,13258,41237,16
godot,pair_2,LogPrompt,InContext,success,2,5,3,0,10,0,11760,5206,16966,10
code-server,pair_3,LogPrompt,InContext,success,1,10,3,0,14,0,20288,10411,30699,14
bubbletea,pair_2,LogPrompt,InContext,success,1,3,6,0,10,0,12096,7110,19206,10
mongoose,pair_4,LogPrompt,InContext,success,1,2,4,0,7,0,7319,4093,11412,7
elasticsearch,pair_3,LogPrompt,CoT,success,2,0,72,0,74,0,260214,64680,324894,74
generative-ai-for-beginners,pair_3,LogPrompt,InContext,success,2,2,2,2,8,0,18194,5076,23270,8
pixijs,pair_3,LogPrompt,InContext,success,1,1,5,0,7,0,7455,4402,11857,7
elasticsearch,pair_4,LogPrompt,CoT,failed,0,0,0,0,0,0,0,0,0,0
cypress,pair_2,LogPrompt,CoT,success,1,0,5,0,6,0,3234,2113,5347,6
jan,pair_4,LogPrompt,InContext,success,4,5,9,3,21,0,60834,16634,77468,21
vllm,pair_3,LogPrompt,CoT,success,1,0,9,9,19,0,20479,12964,33443,19
gpt_academic,pair_3,LogPrompt,CoT,success,2,2,14,5,23,0,81768,16017,97785,23
wtfpython,pair_1,LogPrompt,InContext,success,12,3,2,0,17,0,83327,14441,97768,17
django,pair_3,LogPrompt,CoT,success,0,0,4,1,5,0,3959,2656,6615,5
markitdown,pair_3,LogPrompt,CoT,success,1,0,6,0,7,0,4951,2872,7823,7
insomnia,pair_2,LogPrompt,InContext,success,1,27,4,0,32,0,106743,27868,134611,32
llama_index,pair_2,LogPrompt,InContext,success,3,4,5,0,12,0,15961,8233,24194,12
supabase,pair_4,LogPrompt,InContext,success,1,2,13,0,16,0,34427,13865,48292,16
ink-kit,pair_1,LogPrompt,InContext,success,1,1,7,0,9,0,10675,5544,16219,9
terminal,pair_2,LogPrompt,InContext,success,1,1,1,0,3,0,2225,1100,3325,3
LLMs-from-scratch,pair_3,LogPrompt,CoT,success,1,0,8,2,11,0,12623,7270,19893,11
commander.js,pair_2,LogPrompt,CoT,success,1,1,4,0,6,0,3632,2531,6163,6
supabase,pair_1,LogPrompt,InContext,success,1,5,5,0,11,0,14744,6820,21564,11
nvm,pair_2,LogPrompt,CoT,success,1,1,7,0,9,0,10244,5004,15248,9
PowerShell,pair_4,LogPrompt,CoT,success,1,0,4,0,5,0,2968,1913,4881,5
wtfpython,pair_2,LogPrompt,InContext,success,1,3,2,0,6,0,5741,2765,8506,6
open-webui,pair_1,LogPrompt,CoT,success,1,0,7,0,8,0,5461,3661,9122,8
dify,pair_4,LogPrompt,CoT,success,1,0,13,0,14,0,14793,7914,22707,14
dubbo,pair_2,LogPrompt,CoT,success,24,0,10,106,140,0,324298,134106,458404,140
spark,pair_1,LogPrompt,InContext,success,1,2,0,0,3,0,2248,1447,3695,3
django,pair_2,LogPrompt,CoT,success,0,0,4,1,5,0,4223,2672,6895,5
duckdb,pair_2,LogPrompt,CoT,success,39,0,11,94,144,0,1071103,139184,1210287,144
commander.js,pair_4,LogPrompt,CoT,success,1,1,4,0,6,0,3637,2877,6514,6
spark,pair_3,LogPrompt,CoT,success,1,0,2,0,3,0,1252,1024,2276,3
markitdown,pair_1,LogPrompt,CoT,success,3,0,6,0,9,0,10554,5027,15581,9
meilisearch,pair_4,LogPrompt,CoT,success,9,4,14,17,44,0,90735,38578,129313,44
alpine,pair_1,LogPrompt,InContext,success,0,1,3,3,7,0,16417,4056,20473,7
ionic-framework,pair_1,LogPrompt,InContext,success,16,2,3,7,28,0,64793,24740,89533,28
django,pair_1,LogPrompt,InContext,success,8,4,5,17,34,0,60969,31454,92423,34
duckdb,pair_1,LogPrompt,InContext,success,23,6,114,246,389,0,1604674,384698,1989372,389
netdata,pair_1,LogPrompt,CoT,success,7,1,12,16,36,0,92191,31328,123519,36
jan,pair_1,LogPrompt,InContext,success,4,8,11,4,27,0,60658,22466,83124,27
llama_index,pair_2,LogPrompt,CoT,success,1,1,8,2,12,0,11143,6790,17933,12
commander.js,pair_4,LogPrompt,InContext,success,1,2,3,0,6,0,5942,3996,9938,6
lx-music-desktop,pair_1,LogPrompt,InContext,success,1,5,5,0,11,0,14665,6852,21517,11
LLMs-from-scratch,pair_3,LogPrompt,InContext,success,2,2,6,1,11,0,17077,8564,25641,11
bubbletea,pair_4,LogPrompt,InContext,success,1,99,5,0,105,0,591506,102979,694485,105
n8n,pair_4,LogPrompt,InContext,success,22,7,6,24,59,0,117027,53950,170977,59
pandas,pair_1,LogPrompt,CoT,success,4,5,29,1,39,0,108134,32540,140674,39
AdminLTE,pair_1,LogPrompt,CoT,success,1,0,4,2,7,0,19706,3793,23499,7
ionic-framework,pair_3,LogPrompt,InContext,success,8,1,4,3,16,0,34284,13576,47860,16
dubbo,pair_2,LogPrompt,InContext,success,35,5,5,95,140,0,380312,136038,516350,140
pandas,pair_2,LogPrompt,InContext,success,2,2,17,2,23,0,63939,19656,83595,23
meilisearch,pair_3,LogPrompt,CoT,success,5,4,14,12,35,0,75680,29489,105169,35
PowerShell,pair_2,LogPrompt,CoT,success,1,0,4,1,6,0,4507,3235,7742,6
spark,pair_4,LogPrompt,CoT,success,1,0,2,0,3,0,1258,1025,2283,3
open-webui,pair_3,LogPrompt,InContext,success,2,4,3,45,54,0,145505,49740,195245,54
prettier,pair_3,LogPrompt,InContext,success,151,4,3,33,191,0,430493,188799,619292,191
gpt4all,pair_2,LogPrompt,InContext,success,1,1,4,0,6,0,8077,4224,12301,6
grafana,pair_2,LogPrompt,InContext,success,63,6,28,388,485,0,1450391,482228,1932619,485
AutoGPT,pair_3,LogPrompt,CoT,success,1,0,6,0,7,0,5929,3530,9459,7
spark,pair_2,LogPrompt,CoT,success,1,0,2,0,3,0,1251,1010,2261,3
bruno,pair_1,LogPrompt,InContext,success,1,10,4,0,15,0,17546,10573,28119,15
fuels-ts,pair_2,LogPrompt,CoT,success,1,0,14,0,15,0,16410,8333,24743,15
stats,pair_1,LogPrompt,InContext,success,1,1,8,0,10,0,16359,7133,23492,10
prettier,pair_2,LogPrompt,InContext,success,1,4,4,0,9,0,9236,5358,14594,9
Ghost,pair_2,LogPrompt,InContext,success,4,5,2,4,15,0,42995,13034,56029,15
LLMs-from-scratch,pair_4,LogPrompt,CoT,success,1,0,8,0,9,0,7954,5151,13105,9
lossless-cut,pair_3,LogPrompt,InContext,success,2,1,3,24,30,0,138133,27215,165348,30
insomnia,pair_3,LogPrompt,InContext,success,1,6,5,0,12,0,41669,8195,49864,12
ionic-framework,pair_1,LogPrompt,CoT,success,21,0,5,2,28,0,53411,23985,77396,28
okhttp,pair_3,LogPrompt,CoT,success,2,0,14,5,21,0,30023,13768,43791,21
vault,pair_3,LogPrompt,InContext,success,1,0,2,0,3,0,2163,1247,3410,3
cpython,pair_4,LogPrompt,CoT,success,1,3,143,1,148,0,428783,139535,568318,148
open-webui,pair_2,LogGPT,2,success,1,1,10,0,12,0,4560,706,5266,12
fuels-ts,pair_1,LogGPT,2,success,2,32,100,0,134,0,201261,7571,208832,134
ui,pair_2,LogGPT,1,success,1,3,2,0,6,96,1843,1396,3239,6
spark,pair_1,LogGPT,2,success,1,0,3,0,4,0,1464,174,1638,4
n8n,pair_1,LogGPT,1,success,2,24,411,4,441,26,272015,213812,485827,441
cypress,pair_1,LogGPT,1,success,0,1,7,1,9,0,3615,2752,6367,9
open-webui,pair_1,LogGPT,1,success,1,5,6,0,12,0,4698,3328,8026,12
vllm,pair_4,LogGPT,2,success,14,3,9,74,100,0,74703,4952,79655,100
n8n,pair_4,LogGPT,2,success,31,7,14,120,172,0,113704,7957,121661,172
htmx,pair_1,LogGPT,1,success,3,3,2,0,8,6,3821,3873,7694,8
netdata,pair_3,LogGPT,1,success,15,23,69,65,172,64,117718,93318,211036,172
n8n,pair_2,LogGPT,1,success,1,4,21,1,27,31,17463,14451,31914,27
pixijs,pair_1,LogGPT,2,success,4,3,9,0,16,0,7744,995,8739,16
AutoGPT,pair_4,LogGPT,2,success,12,2,7,0,21,2,967111,1457,968568,21
markitdown,pair_3,LogGPT,1,success,1,5,5,0,11,0,4676,3903,8579,11
laravel,pair_2,LogGPT,1,success,2,5,17,0,24,1,12825,9813,22638,24
wtfpython,pair_1,LogGPT,1,success,0,4,3,0,7,39,2900,2546,5446,7
okhttp,pair_1,LogGPT,2,success,14,5,21,29,69,0,52622,4314,56936,69
django,pair_1,LogGPT,2,success,21,6,13,61,101,0,58791,5817,64608,101
youtube-dl,pair_1,LogGPT,2,success,1,5,15,0,21,0,9939,1005,10944,21
slate,pair_3,LogGPT,1,success,1,2,6,3,12,2,6099,4907,11006,12
open-webui,pair_1,LogGPT,2,success,1,5,6,0,12,0,4871,746,5617,12
ink-kit,pair_1,LogGPT,1,success,1,3,13,0,17,0,7775,6088,13863,17
llama_index,pair_4,LogGPT,2,success,2,4,31,1,38,0,23990,1499,25489,38
starship,pair_4,LogGPT,2,success,1,2,7,0,10,0,4408,475,4883,10
ink-kit,pair_3,LogGPT,2,success,1,4,7,0,12,0,4789,669,5458,12
mongoose,pair_4,LogGPT,1,success,0,3,6,1,10,0,4399,3760,8159,10
terraform,pair_3,LogGPT,2,success,2,0,7,2,11,0,5224,508,5732,11
vllm,pair_1,LogGPT,2,success,4,3,9,47,63,0,39439,2579,42018,63
bubbletea,pair_1,LogGPT,1,success,1,3,13,0,17,1,8578,6907,15485,17
cockroach,pair_3,LogGPT,2,success,1,1,2,0,4,0,1707,242,1949,4
cpython,pair_4,LogGPT,2,success,4,22,433,1,460,0,475104,15155,490259,460
stats,pair_3,LogGPT,2,success,1,3,18,0,22,0,9468,886,10354,22
ollama,pair_1,LogGPT,2,success,1,1,5,4,11,0,5844,428,6272,11
playwright,pair_4,LogGPT,1,success,4,3,4,9,20,0,11733,9329,21062,20
dubbo,pair_3,LogGPT,1,success,5,3,11,418,437,10,343954,292760,636714,437
markitdown,pair_2,LogGPT,1,success,4,3,6,4,17,1,10222,8614,18836,17
julia,pair_2,LogGPT,2,success,1,2,6,0,9,0,3376,427,3803,9
nvm,pair_4,LogGPT,1,success,2,4,9,1,16,1,9661,7960,17621,16
terraform,pair_2,LogGPT,2,success,5,2,8,7,22,0,15882,1089,16971,22
prettier,pair_2,LogGPT,1,success,1,3,8,0,12,1,5027,3720,8747,12
PowerShell,pair_1,LogGPT,2,success,3,2,4,2,11,0,5017,870,5887,11
spring-boot,pair_4,LogGPT,1,success,2,8,18,1,29,0,16797,13429,30226,29
prettier,pair_3,LogGPT,2,success,504,4,7,109,624,0,423498,80878,504376,624
fabric,pair_3,LogGPT,2,success,1,1,9,0,11,0,5897,448,6345,11
jan,pair_1,LogGPT,2,success,9,7,39,15,70,0,56854,3553,60407,70
okhttp,pair_3,LogGPT,1,success,1,11,15,20,47,2,31409,26066,57475,47
bubbletea,pair_3,LogGPT,1,success,2,2,3,0,7,3,3110,1426,4536,7
markitdown,pair_4,LogGPT,2,success,24,1,8,17,50,0,32969,5510,38479,50
markitdown,pair_3,LogGPT,2,success,1,3,7,0,11,0,4555,618,5173,11
cypress,pair_3,LogGPT,2,success,1,1,7,0,9,0,3407,395,3802,9
cpython,pair_1,LogGPT,1,success,33,11,93,93,230,40,192142,160282,352424,230
AutoGPT,pair_3,LogGPT,2,success,1,2,7,2,12,0,6237,556,6793,12
starship,pair_1,LogGPT,2,success,1,4,5,0,10,0,4389,535,4924,10
meilisearch,pair_2,LogGPT,1,success,1,6,15,0,22,0,10568,8316,18884,22
htmx,pair_2,LogGPT,1,success,1,2,7,0,10,0,4116,2978,7094,10
fabric,pair_4,LogGPT,1,success,1,5,35,0,41,7,24186,19869,44055,41
terminal,pair_4,LogGPT,2,success,1,0,2,0,3,0,1000,166,1166,3
retrofit,pair_2,LogGPT,2,success,5,1,14,6,26,0,16533,1541,18074,26
LLMs-from-scratch,pair_4,LogGPT,2,success,1,4,14,0,19,0,8779,908,9687,19
neovim,pair_1,LogGPT,2,success,4,20,169,4,197,0,175811,7954,183765,197
cypress,pair_2,LogGPT,2,success,1,3,5,0,9,0,3427,589,4016,9
pandas,pair_1,LogGPT,1,success,5,6,66,9,86,22,66000,53041,119041,86
gpt4all,pair_1,LogGPT,1,success,0,4,4,1,9,1,4908,4465,9373,9
slate,pair_1,LogGPT,1,success,11,35,50,46,142,1,90262,72317,162579,142
lx-music-desktop,pair_1,LogGPT,1,success,2,4,11,0,17,3,7841,6130,13971,17
ionic-framework,pair_2,LogGPT,2,success,12,1,7,7,27,0,18797,2360,21157,27
meilisearch,pair_1,LogGPT,1,success,1,4,17,0,22,0,10046,7082,17128,22
tailwindcss,pair_2,LogGPT,2,success,5,10,35,4,54,0,41143,3621,44764,54
n8n,pair_3,LogGPT,2,success,4,14,35,6,59,0,117482,3223,120705,59
fabric,pair_2,LogGPT,1,success,2,5,23,1,31,4,17518,14064,31582,31
ColossalAI,pair_2,LogGPT,2,success,1075,18,47,417,1557,0,1178949,176713,1355662,1557
flask,pair_2,LogGPT,2,success,6,2,8,4,20,0,11051,1290,12341,20
pixijs,pair_3,LogGPT,2,success,2,6,4,0,12,0,5099,1230,6329,12
django,pair_3,LogGPT,2,success,2,1,5,1,9,0,4258,489,4747,9
stable-diffusion-webui,pair_4,LogGPT,1,success,0,3,6,1,10,0,3695,3121,6816,10
julia,pair_2,LogGPT,1,success,1,2,6,0,9,0,3468,2384,5852,9
terraform,pair_1,LogGPT,1,success,6,2,8,8,24,0,17478,14667,32145,24
jan,pair_2,LogGPT,2,success,9,7,39,15,70,0,56552,3564,60116,70
ink-kit,pair_1,LogGPT,2,success,1,5,11,0,17,0,8046,872,8918,17
duckdb,pair_4,LogGPT,1,success,2,8,214,1,225,160,218713,185324,404037,225
django,pair_3,LogGPT,1,success,1,3,3,2,9,0,4225,3219,7444,9
netdata,pair_4,LogGPT,2,success,16,4,23,36,79,0,65109,4117,69226,79
godot,pair_1,LogGPT,1,success,2,15,121,0,138,93,151332,77817,229149,138
cypress,pair_1,LogGPT,2,success,1,1,7,0,9,0,3362,380,3742,9
ink-kit,pair_3,LogGPT,1,success,1,3,8,0,12,0,4900,3473,8373,12
ColossalAI,pair_4,LogGPT,2,success,8,10,54,1,73,0,84310,4191,88501,73
tailwindcss,pair_1,LogGPT,2,success,8,7,31,11,57,0,43490,3329,46819,57
htmx,pair_1,LogGPT,2,success,2,1,4,7,14,0,13053,728,13781,14
lossless-cut,pair_3,LogGPT,2,success,6,2,3,79,90,0,138098,3193,141291,90
starship,pair_2,LogGPT,2,success,1,4,5,0,10,0,4527,635,5162,10
alpine,pair_2,LogGPT,1,success,28,7,14,0,49,0,32619,26905,59524,49
insomnia,pair_3,LogGPT,2,success,3,8,12,0,23,0,40065,1956,42021,23
playwright,pair_3,LogGPT,1,success,2,3,13,8,26,1,15858,12843,28701,26
dubbo,pair_3,LogGPT,2,success,19,2,12,414,447,0,364918,14435,379353,447
fuels-ts,pair_2,LogGPT,2,success,1,5,22,0,28,0,18812,1435,20247,28
AutoGPT,pair_4,LogGPT,1,success,7,2,7,2,18,3,789406,3761,793167,18
PowerShell,pair_2,LogGPT,1,success,2,1,5,3,11,0,4794,3766,8560,11
godot,pair_4,LogGPT,1,success,4,2,9,3,18,0,8990,6703,15693,18
prettier,pair_2,LogGPT,2,success,1,6,6,0,13,0,6542,900,7442,13
hugo,pair_3,LogGPT,2,success,13,14,69,12,108,0,80312,5638,85950,108
spring-boot,pair_4,LogGPT,2,success,2,5,21,1,29,0,16627,1255,17882,29
terminal,pair_1,LogGPT,1,success,1,1,1,0,3,0,1020,983,2003,3
cypress,pair_4,LogGPT,1,success,1,1,7,0,9,0,3335,2428,5763,9
mantine,pair_1,LogGPT,1,success,1,5,23,1,30,2,16457,12501,28958,30
lx-music-desktop,pair_1,LogGPT,2,success,2,4,14,0,20,0,12632,1177,13809,20
cpython,pair_1,LogGPT,2,success,37,29,107,97,270,0,320328,15174,335502,270
alpine,pair_1,LogGPT,1,success,2,3,2,0,7,8,2999,2319,5318,7
AutoGPT,pair_3,LogGPT,1,success,1,3,6,2,12,0,6480,5025,11505,12
insomnia,pair_1,LogGPT,2,success,4,57,26,0,87,0,111876,10488,122364,87
dubbo,pair_4,LogGPT,1,success,5,3,11,419,438,9,346111,293024,639135,438
django,pair_4,LogGPT,2,success,1,3,9,0,13,0,7705,547,8252,13
supabase,pair_2,LogGPT,2,success,1,5,34,2,42,0,32665,1887,34552,42
laravel,pair_3,LogGPT,1,success,1,4,18,1,24,1,12905,10548,23453,24
ColossalAI,pair_3,LogGPT,1,success,954,9,38,465,1466,93,1033167,834305,1867472,1466
netdata,pair_1,LogGPT,2,success,28,6,24,46,104,0,102357,6463,108820,104
prettier,pair_1,LogGPT,1,success,1,4,6,0,11,1,4412,3112,7524,11
alpine,pair_2,LogGPT,2,success,28,4,17,0,49,0,32709,4878,37587,49
julia,pair_1,LogGPT,1,success,1,3,4,2,10,0,5026,3570,8596,10
gpt4all,pair_1,LogGPT,2,success,1,2,7,0,10,0,6391,492,6883,10
fuels-ts,pair_1,LogGPT,1,success,1,9,49,1,60,74,48883,40547,89430,60
elasticsearch,pair_4,LogGPT,1,failed,0,0,0,0,0,0,0,0,0,0
django,pair_2,LogGPT,2,success,2,3,3,2,10,0,4577,851,5428,10
code-server,pair_3,LogGPT,2,success,1,6,20,0,27,0,16196,1653,17849,27
cpython,pair_3,LogGPT,2,success,4,2,8,5,19,0,9726,990,10716,19
starship,pair_2,LogGPT,1,success,1,2,7,0,10,0,4348,2686,7034,10
playwright,pair_1,LogGPT,2,success,9,2,5,50,66,0,81683,3191,84874,66
bubbletea,pair_2,LogGPT,2,success,2,2,13,0,17,0,9380,788,10168,17
commander.js,pair_2,LogGPT,1,success,1,3,5,0,9,0,3800,3109,6909,9
godot,pair_2,LogGPT,2,success,2,1,10,5,18,0,8625,779,9404,18
flask,pair_1,LogGPT,1,success,4,6,5,3,18,0,8974,7368,16342,18
spark,pair_4,LogGPT,2,success,1,0,3,0,4,0,1551,175,1726,4
n8n,pair_1,LogGPT,2,success,5,69,373,20,467,0,335832,20442,356274,467
pandas,pair_4,LogGPT,2,failed,0,0,0,0,0,0,0,0,0,0
hugo,pair_4,LogGPT,2,success,14,7,76,11,108,0,78998,5832,84830,108
okhttp,pair_2,LogGPT,1,success,3,7,18,25,53,3,33885,28200,62085,53
supabase,pair_1,LogGPT,1,success,1,4,12,0,17,2,8449,6745,15194,17
AutoGPT,pair_1,LogGPT,2,success,13,4,5,0,22,0,984683,1758,986441,22
code-server,pair_3,LogGPT,1,success,1,6,20,0,27,0,15974,13326,29300,27
vault,pair_3,LogGPT,2,success,1,0,3,0,4,0,1148,150,1298,4
netdata,pair_3,LogGPT,2,success,27,25,68,116,236,0,225930,11200,237130,236
stable-diffusion-webui,pair_3,LogGPT,2,success,1,4,5,0,10,0,3472,613,4085,10
spark,pair_2,LogGPT,1,success,1,2,1,0,4,0,1468,994,2462,4
pixijs,pair_1,LogGPT,1,success,3,3,9,1,16,0,7545,5951,13496,16
ionic-framework,pair_4,LogGPT,2,success,9,1,7,97,114,0,81334,4276,85610,114
fuels-ts,pair_2,LogGPT,1,success,1,10,17,0,28,0,18680,15318,33998,28
insomnia,pair_3,LogGPT,1,success,3,4,11,0,18,5,8923,7245,16168,18
llama_index,pair_2,LogGPT,2,success,2,2,13,6,23,0,12174,988,13162,23
grafana,pair_2,LogGPT,1,success,68,7,42,1302,1419,185,1167696,973710,2141406,1419
code-server,pair_1,LogGPT,2,success,1,9,16,0,26,0,15935,1804,17739,26
AdminLTE,pair_1,LogGPT,1,success,3,3,2,2,10,5,14190,3552,17742,10
pandas,pair_4,LogGPT,1,failed,0,0,0,0,0,0,0,0,0,0
grafana,pair_3,LogGPT,1,success,3,1,9,2,15,7,9159,7349,16508,15
jan,pair_2,LogGPT,1,success,4,6,40,9,59,11,38474,25576,64050,59
flask,pair_1,LogGPT,2,success,5,4,7,2,18,0,8815,1238,10053,18
insomnia,pair_2,LogGPT,2,success,3,57,29,0,89,0,113157,9010,122167,89
certbot,pair_1,LogGPT,2,success,1,1,2,0,4,0,1214,227,1441,4
playwright,pair_2,LogGPT,1,success,1,4,48,1,54,7,44854,36393,81247,54
grafana,pair_1,LogGPT,2,success,2,1,12,2,17,0,9882,789,10671,17
duckdb,pair_4,LogGPT,2,success,2,13,369,1,385,0,454226,12603,466829,385
jan,pair_3,LogGPT,2,success,8,4,42,18,72,0,57767,3268,61035,72
gpt_academic,pair_2,LogGPT,1,success,5,7,26,7,45,7,25355,19766,45121,45
dify,pair_3,LogGPT,1,success,2,7,30,15,54,0,32995,26167,59162,54
open-webui,pair_2,LogGPT,1,success,1,5,6,0,12,0,4583,3238,7821,12
LLMs-from-scratch,pair_2,LogGPT,2,success,3,2,15,0,20,0,9911,1055,10966,20
commander.js,pair_2,LogGPT,2,success,1,2,6,0,9,0,3580,508,4088,9
ColossalAI,pair_3,LogGPT,2,success,1053,14,51,441,1559,0,1183643,175467,1359110,1559
cpython,pair_2,LogGPT,2,success,7,2,8,3,20,0,10189,1375,11564,20
dify,pair_4,LogGPT,2,success,1,5,22,0,28,0,16241,1176,17417,28
generative-ai-for-beginners,pair_3,LogGPT,1,success,3,2,2,1,8,8,5118,4383,9501,8
slate,pair_4,LogGPT,1,success,2,3,4,2,11,2,5830,5000,10830,11
nvm,pair_3,LogGPT,2,success,1,2,5,0,8,0,4965,417,5382,8
pixijs,pair_4,LogGPT,1,success,2,4,6,0,12,0,4790,3621,8411,12
generative-ai-for-beginners,pair_1,LogGPT,2,success,3,0,4,7,14,0,14116,757,14873,14
julia,pair_1,LogGPT,2,success,3,2,5,0,10,0,4653,577,5230,10
nvm,pair_4,LogGPT,2,success,3,4,10,0,17,0,11211,1640,12851,17
lossless-cut,pair_1,LogGPT,1,success,1,1,4,2,8,82,5355,2122,7477,8
cockroach,pair_1,LogGPT,2,success,2,5,14,7,28,0,20367,1409,21776,28
tailwindcss,pair_2,LogGPT,1,success,2,5,37,6,50,4,34116,28880,62996,50
PowerShell,pair_3,LogGPT,1,success,2,1,5,3,11,0,4830,3470,8300,11
laravel,pair_4,LogGPT,2,success,2,5,18,0,25,0,18976,1106,20082,25
spring-boot,pair_3,LogGPT,1,success,8,4,9,25,46,2,35118,29372,64490,46
gpt_academic,pair_1,LogGPT,1,success,4,6,27,8,45,12,29703,18585,48288,45
starship,pair_4,LogGPT,1,success,1,3,6,0,10,0,4361,3799,8160,10
grafana,pair_1,LogGPT,1,success,0,1,12,3,16,1,8285,6968,15253,16
meilisearch,pair_2,LogGPT,2,success,1,4,17,0,22,0,10720,1019,11739,22
mongoose,pair_3,LogGPT,2,success,3,1,4,7,15,0,14405,701,15106,15
grafana,pair_4,LogGPT,2,success,313,3,10,0,326,0,339721,60801,400522,326
markitdown,pair_1,LogGPT,1,success,2,2,7,6,17,1,10161,8518,18679,17
elasticsearch,pair_1,LogGPT,1,success,1,10,12,0,23,0,12564,10165,22729,23
slate,pair_2,LogGPT,1,success,1,2,6,3,12,1,7020,4493,11513,12
uv,pair_3,LogGPT,2,success,21,4,20,61,106,0,255780,5098,260878,106
meilisearch,pair_3,LogGPT,2,success,12,9,37,43,101,0,93479,5072,98551,101
elasticsearch,pair_3,LogGPT,2,success,3,8,204,1,216,0,288755,7238,295993,216
hugo,pair_1,LogGPT,2,success,8,112,90,7,217,0,166920,11770,178690,217
flask,pair_2,LogGPT,1,success,3,4,6,7,20,0,10967,8759,19726,20
stable-diffusion-webui,pair_2,LogGPT,2,success,1,0,9,0,10,0,3651,464,4115,10
commander.js,pair_3,LogGPT,1,success,1,2,6,0,9,0,3686,2786,6472,9
prettier,pair_4,LogGPT,2,success,1,12,20,0,33,0,20033,2101,22134,33
AdminLTE,pair_1,LogGPT,2,success,4,2,3,6,15,0,21463,867,22330,15
llama_index,pair_1,LogGPT,2,success,2,5,30,1,38,0,24148,1499,25647,38
vllm,pair_3,LogGPT,1,success,4,2,10,30,46,0,24478,18878,43356,46
gpt4all,pair_4,LogGPT,1,success,0,1,7,1,9,1,4821,3920,8741,9
supabase,pair_3,LogGPT,2,success,1,3,15,0,19,0,10920,723,11643,19
pixijs,pair_2,LogGPT,1,success,0,3,4,0,7,1,2778,2097,4875,7
mongoose,pair_1,LogGPT,2,success,13,3,10,145,171,0,253899,5687,259586,171
Ghost,pair_1,LogGPT,1,success,11,1,16,7,35,81,40381,18087,58468,35
dify,pair_1,LogGPT,1,success,1,1,7,0,9,1,3312,2583,5895,9
bubbletea,pair_4,LogGPT,1,success,1,15,7,0,23,318,25165,6126,31291,23
retrofit,pair_2,LogGPT,1,success,4,2,13,7,26,0,16570,14031,30601,26
gpt4all,pair_2,LogGPT,2,success,1,2,7,0,10,0,6344,482,6826,10
wtfpython,pair_1,LogGPT,2,success,26,1,6,13,46,0,80858,11934,92792,46
pixijs,pair_3,LogGPT,1,success,1,4,6,1,12,0,4895,4208,9103,12
slate,pair_4,LogGPT,2,success,4,3,4,2,13,0,9388,846,10234,13
dify,pair_4,LogGPT,1,success,1,11,16,0,28,0,16472,12710,29182,28
vllm,pair_4,LogGPT,1,success,4,1,11,80,96,4,69114,55679,124793,96
playwright,pair_4,LogGPT,2,success,6,1,6,7,20,0,11502,1580,13082,20
certbot,pair_3,LogGPT,1,success,1,0,7,0,8,0,3981,2840,6821,8
youtube-dl,pair_2,LogGPT,1,success,6,8,26,7,47,0,28313,22858,51171,47
terminal,pair_1,LogGPT,2,success,1,0,2,0,3,0,970,166,1136,3
terminal,pair_3,LogGPT,1,success,1,1,1,0,3,0,947,706,1653,3
stats,pair_4,LogGPT,2,success,1,4,17,0,22,0,9418,1013,10431,22
certbot,pair_4,LogGPT,2,success,1,1,6,0,8,0,3972,357,4329,8
terraform,pair_3,LogGPT,1,success,0,1,6,4,11,0,5250,4164,9414,11
Ghost,pair_2,LogGPT,2,success,6,3,10,21,40,0,46767,1799,48566,40
fzf,pair_1,LogGPT,1,success,1,7,16,0,24,0,12190,9589,21779,24
netdata,pair_2,LogGPT,2,success,19,11,42,57,129,0,106298,6007,112305,129
supabase,pair_2,LogGPT,1,success,0,2,37,0,39,3,25461,20327,45788,39
commander.js,pair_1,LogGPT,1,success,1,3,11,1,16,0,6920,5806,12726,16
certbot,pair_1,LogGPT,1,success,1,2,1,0,4,0,1144,918,2062,4
code-server,pair_2,LogGPT,2,success,1,8,20,0,29,0,16654,1444,18098,29
playwright,pair_1,LogGPT,1,success,1,2,5,48,56,10,57609,39240,96849,56
LLMs-from-scratch,pair_2,LogGPT,1,success,3,2,15,0,20,0,10015,7434,17449,20
pandas,pair_2,LogGPT,2,success,10,6,44,2,62,0,61549,3124,64673,62
vault,pair_1,LogGPT,2,success,1,5,109,2,117,0,120337,3705,124042,117
spark,pair_3,LogGPT,1,success,1,1,2,0,4,0,1564,1119,2683,4
AutoGPT,pair_2,LogGPT,2,success,1,1,8,0,10,1,4671,620,5291,10
stable-diffusion-webui,pair_3,LogGPT,1,success,0,3,6,1,10,0,3718,2531,6249,10
insomnia,pair_2,LogGPT,1,success,3,23,38,0,64,25,50888,38080,88968,64
ui,pair_1,LogGPT,2,success,3,1,4,6,14,0,14384,778,15162,14
dify,pair_2,LogGPT,2,success,4,7,26,12,49,0,29063,2270,31333,49
prettier,pair_1,LogGPT,2,success,1,5,6,0,12,0,5836,717,6553,12
duckdb,pair_2,LogGPT,1,success,19,4,19,275,317,149,257679,190155,447834,317
stats,pair_3,LogGPT,1,success,1,6,15,0,22,0,9507,6828,16335,22
supabase,pair_4,LogGPT,1,success,0,2,37,1,40,2,28384,20148,48532,40
godot,pair_1,LogGPT,2,success,2,23,206,0,231,0,388386,9135,397521,231
laravel,pair_1,LogGPT,1,success,1,2,20,1,24,1,12923,10171,23094,24
generative-ai-for-beginners,pair_1,LogGPT,1,success,2,2,2,0,6,8,2833,2280,5113,6
uv,pair_2,LogGPT,2,success,18,7,17,66,108,0,260194,4767,264961,108
llama_index,pair_2,LogGPT,1,success,1,2,13,7,23,0,12359,9539,21898,23
julia,pair_3,LogGPT,1,success,1,2,5,2,10,0,4845,3750,8595,10
cockroach,pair_3,LogGPT,1,success,1,1,2,0,4,0,1742,1559,3301,4
supabase,pair_1,LogGPT,2,success,1,2,16,0,19,0,11199,723,11922,19
julia,pair_3,LogGPT,2,success,2,1,6,1,10,0,4864,549,5413,10
open-webui,pair_3,LogGPT,1,success,1,2,8,132,143,21,116272,97589,213861,143
jan,pair_1,LogGPT,1,success,2,7,39,11,59,11,36312,25028,61340,59
generative-ai-for-beginners,pair_3,LogGPT,2,success,3,0,4,9,16,0,16916,619,17535,16
wtfpython,pair_2,LogGPT,2,success,1,3,4,0,8,0,3265,524,3789,8
elasticsearch,pair_2,LogGPT,2,success,1,4,17,0,22,0,11912,1024,12936,22
n8n,pair_4,LogGPT,1,success,15,5,14,129,163,9,100670,80348,181018,163
wtfpython,pair_4,LogGPT,1,success,0,1,6,1,8,0,3207,2409,5616,8
starship,pair_1,LogGPT,1,success,1,2,7,0,10,0,4483,3372,7855,10
stats,pair_2,LogGPT,2,success,1,2,20,0,23,0,10121,875,10996,23
django,pair_1,LogGPT,1,success,18,5,13,64,100,1,57089,43399,100488,100
lossless-cut,pair_2,LogGPT,2,success,6,0,5,79,90,0,137878,3184,141062,90
PowerShell,pair_4,LogGPT,2,success,1,3,4,0,8,0,3139,519,3658,8
grafana,pair_2,LogGPT,2,success,146,12,89,1357,1604,0,1447952,63024,1510976,1604
PowerShell,pair_3,LogGPT,2,success,3,2,4,2,11,0,4954,548,5502,11
wtfpython,pair_4,LogGPT,2,success,1,2,5,0,8,0,3249,583,3832,8
RxJava,pair_1,LogGPT,1,success,8,4,7,12,31,0,21042,17116,38158,31
open-webui,pair_4,LogGPT,1,success,2,2,6,0,10,0,4123,3132,7255,10
flask,pair_4,LogGPT,1,success,7,5,9,155,176,0,137495,111502,248997,176
ionic-framework,pair_3,LogGPT,2,success,27,1,7,9,44,0,32690,4754,37444,44
ionic-framework,pair_1,LogGPT,2,success,53,3,5,21,82,0,63635,9763,73398,82
certbot,pair_2,LogGPT,2,success,1,0,3,0,4,0,1138,196,1334,4
ColossalAI,pair_2,LogGPT,1,success,946,12,34,478,1470,87,1035175,841240,1876415,1470
terraform,pair_1,LogGPT,2,success,8,4,6,6,24,0,17695,1495,19190,24
LLMs-from-scratch,pair_3,LogGPT,2,success,5,4,13,3,25,0,14157,1369,15526,25
pandas,pair_1,LogGPT,2,success,9,21,72,6,108,0,120095,6465,126560,108
certbot,pair_4,LogGPT,1,success,1,1,6,0,8,0,3784,2784,6568,8
stats,pair_2,LogGPT,1,success,1,5,17,0,23,0,9477,7560,17037,23
llama_index,pair_4,LogGPT,1,success,1,6,29,2,38,0,23857,18909,42766,38
terraform,pair_2,LogGPT,1,success,3,1,9,9,22,0,15873,13273,29146,22
commander.js,pair_4,LogGPT,2,success,1,3,5,0,9,0,3729,610,4339,9
AdminLTE,pair_2,LogGPT,1,success,2,1,9,3,15,0,8665,7079,15744,15
fuels-ts,pair_3,LogGPT,1,success,5,3,56,16,80,101,78632,57770,136402,80
gpt4all,pair_3,LogGPT,2,success,1,2,7,0,10,0,6022,577,6599,10
duckdb,pair_1,LogGPT,2,success,62,9,374,834,1279,0,1596758,43633,1640391,1279
duckdb,pair_2,LogGPT,2,success,59,7,16,384,466,0,1132469,29271,1161740,466
godot,pair_2,LogGPT,1,success,4,3,8,3,18,0,8535,7236,15771,18
gpt4all,pair_4,LogGPT,2,success,1,4,5,0,10,0,5913,648,6561,10
stats,pair_1,LogGPT,2,success,1,4,18,0,23,0,9858,1029,10887,23
retrofit,pair_3,LogGPT,1,success,9,5,14,369,397,2,275447,215566,491013,397
youtube-dl,pair_1,LogGPT,1,success,0,5,15,1,21,0,9867,7453,17320,21
ionic-framework,pair_3,LogGPT,1,success,22,4,4,13,43,1,30672,25532,56204,43
RxJava,pair_1,LogGPT,2,success,13,4,7,7,31,0,21111,2609,23720,31
PowerShell,pair_1,LogGPT,1,success,4,2,4,1,11,0,5059,3709,8768,11
netdata,pair_1,LogGPT,1,success,8,9,21,44,82,22,72796,51729,124525,82
ionic-framework,pair_2,LogGPT,1,success,6,4,4,12,26,1,17023,14350,31373,26
stable-diffusion-webui,pair_1,LogGPT,2,success,1,2,7,0,10,0,3553,550,4103,10
bubbletea,pair_4,LogGPT,2,success,1,331,9,0,341,0,585810,27731,613541,341
vault,pair_1,LogGPT,1,success,1,11,60,2,74,43,57701,45593,103294,74
PowerShell,pair_2,LogGPT,2,success,2,2,4,3,11,0,5168,529,5697,11
gpt4all,pair_2,LogGPT,1,success,1,2,7,0,10,0,5948,4809,10757,10
jan,pair_4,LogGPT,2,success,12,4,27,11,54,0,60773,3065,63838,54
fzf,pair_1,LogGPT,2,success,1,7,16,0,24,0,12176,1361,13537,24
playwright,pair_3,LogGPT,2,success,3,1,16,7,27,0,18013,1064,19077,27
spring-boot,pair_2,LogGPT,2,success,3,4,22,0,29,0,16866,1200,18066,29
cypress,pair_3,LogGPT,1,success,1,3,5,0,9,0,3295,2445,5740,9
commander.js,pair_4,LogGPT,1,success,1,3,5,0,9,0,3693,3109,6802,9
django,pair_2,LogGPT,1,success,1,3,3,3,10,0,4699,3375,8074,10
nvm,pair_1,LogGPT,2,success,1,3,4,0,8,0,5143,452,5595,8
gpt_academic,pair_3,LogGPT,1,success,3,3,30,11,47,9,43617,18802,62419,47
certbot,pair_2,LogGPT,1,success,1,3,0,0,4,0,1121,1183,2304,4
vault,pair_2,LogGPT,2,success,1,1,2,0,4,0,1191,235,1426,4
wtfpython,pair_3,LogGPT,1,success,1,2,5,0,8,0,3181,2488,5669,8
prettier,pair_3,LogGPT,1,success,429,1,9,184,623,1,420478,343972,764450,623
uv,pair_3,LogGPT,1,success,2,3,14,5,24,82,26518,11014,37532,24
pandas,pair_3,LogGPT,2,success,1,18,136,0,155,0,135659,6888,142547,155
markitdown,pair_4,LogGPT,1,success,21,2,7,18,48,2,31332,25719,57051,48
playwright,pair_2,LogGPT,2,success,1,3,56,1,61,0,55531,2043,57574,61
lossless-cut,pair_2,LogGPT,1,success,1,3,2,1,7,83,3640,1907,5547,7
n8n,pair_3,LogGPT,1,success,3,4,23,1,31,28,55502,15705,71207,31
hugo,pair_1,LogGPT,1,success,3,114,80,11,208,9,151059,120808,271867,208
elasticsearch,pair_2,LogGPT,1,success,1,8,13,0,22,0,12055,9510,21565,22
laravel,pair_4,LogGPT,1,success,1,2,20,1,24,1,13028,9790,22818,24
dubbo,pair_4,LogGPT,2,success,32,6,8,401,447,0,365399,15650,381049,447
spring-boot,pair_1,LogGPT,2,success,2,4,22,1,29,0,16633,1252,17885,29
spark,pair_4,LogGPT,1,success,1,1,2,0,4,0,1488,1111,2599,4
terminal,pair_4,LogGPT,1,success,1,1,1,0,3,0,1050,783,1833,3
neovim,pair_1,LogGPT,1,success,1,6,158,4,169,28,122038,98051,220089,169
open-webui,pair_3,LogGPT,2,success,1,4,6,153,164,0,144040,5162,149202,164
elasticsearch,pair_4,LogGPT,2,failed,0,0,0,0,0,0,0,0,0,0
ui,pair_1,LogGPT,1,success,1,3,2,1,7,7,2955,3070,6025,7
llama_index,pair_3,LogGPT,1,success,1,3,12,7,23,0,12376,9867,22243,23
bubbletea,pair_1,LogGPT,2,success,2,4,12,0,18,0,9965,915,10880,18
uv,pair_1,LogGPT,1,success,2,3,17,5,27,85,28213,11401,39614,27
mantine,pair_1,LogGPT,2,success,1,5,25,1,32,0,23632,1862,25494,32
code-server,pair_1,LogGPT,1,success,1,3,22,0,26,0,15740,12896,28636,26
LLMs-from-scratch,pair_1,LogGPT,1,success,1,4,14,0,19,0,9041,6660,15701,19
starship,pair_3,LogGPT,2,success,1,3,6,0,10,0,4281,565,4846,10
okhttp,pair_2,LogGPT,2,success,11,5,21,19,56,0,39203,3124,42327,56
llama_index,pair_1,LogGPT,1,success,2,7,28,1,38,0,24161,19509,43670,38
fabric,pair_2,LogGPT,2,success,2,3,25,5,35,0,24529,1423,25952,35
lossless-cut,pair_1,LogGPT,2,success,7,1,4,78,90,0,138113,3334,141447,90
godot,pair_3,LogGPT,1,success,4,5,6,3,18,2,9168,7056,16224,18
dubbo,pair_2,LogGPT,1,success,4,2,12,420,438,9,346433,292405,638838,438
cpython,pair_3,LogGPT,1,success,2,3,7,7,19,0,9904,7840,17744,19
stats,pair_1,LogGPT,1,success,1,8,14,0,23,0,9891,7239,17130,23
julia,pair_4,LogGPT,2,success,1,2,3,0,6,0,4443,414,4857,6
jan,pair_4,LogGPT,1,success,3,9,22,5,39,15,28722,18510,47232,39
flask,pair_3,LogGPT,1,success,16,4,10,186,216,90,306206,130817,437023,216
fabric,pair_1,LogGPT,1,success,2,2,2,6,12,104,10098,7939,18037,12
prettier,pair_4,LogGPT,1,success,1,1,28,0,30,3,15096,11743,26839,30
slate,pair_3,LogGPT,2,success,4,3,5,2,14,0,9669,1048,10717,14
open-webui,pair_4,LogGPT,2,success,2,1,7,0,10,0,4260,886,5146,10
dify,pair_2,LogGPT,1,success,5,5,28,11,49,0,28874,23441,52315,49
dubbo,pair_2,LogGPT,2,success,22,3,11,411,447,0,365498,14390,379888,447
terminal,pair_2,LogGPT,2,success,1,0,2,0,3,0,940,158,1098,3
hugo,pair_4,LogGPT,1,success,12,3,79,13,107,1,77951,64760,142711,107
okhttp,pair_1,LogGPT,1,success,5,11,14,32,62,7,41387,34576,75963,62
wtfpython,pair_3,LogGPT,2,success,1,4,3,0,8,0,3328,710,4038,8
vault,pair_3,LogGPT,1,success,1,2,1,0,4,0,1217,1089,2306,4
elasticsearch,pair_1,LogGPT,2,success,1,4,18,0,23,0,12489,1104,13593,23
lossless-cut,pair_4,LogGPT,2,success,7,0,5,78,90,0,137839,3418,141257,90
laravel,pair_3,LogGPT,2,success,2,4,19,0,25,0,19551,1120,20671,25
uv,pair_2,LogGPT,1,success,3,2,15,4,24,84,24712,10967,35679,24
vllm,pair_1,LogGPT,1,success,4,4,8,47,63,0,39415,30371,69786,63
pixijs,pair_4,LogGPT,2,success,2,3,7,0,12,0,4845,767,5612,12
vllm,pair_2,LogGPT,2,success,9,24,205,1,239,0,322430,10644,333074,239
slate,pair_2,LogGPT,2,success,4,1,7,1,13,0,9257,768,10025,13
ionic-framework,pair_4,LogGPT,1,success,4,4,4,101,113,1,79974,65064,145038,113
ColossalAI,pair_1,LogGPT,2,success,2,3,22,1,28,0,14846,1183,16029,28
commander.js,pair_1,LogGPT,2,success,2,6,8,0,16,0,7079,946,8025,16
LLMs-from-scratch,pair_3,LogGPT,1,success,4,3,14,4,25,0,14066,11157,25223,25
n8n,pair_2,LogGPT,2,success,5,14,34,5,58,0,116161,3205,119366,58
llama_index,pair_3,LogGPT,2,success,2,4,11,6,23,0,12202,1096,13298,23
meilisearch,pair_4,LogGPT,1,success,4,5,37,77,123,8,102435,82996,185431,123
cypress,pair_4,LogGPT,2,success,1,2,6,0,9,0,3387,433,3820,9
godot,pair_4,LogGPT,2,success,5,5,6,2,18,0,8867,1149,10016,18
pandas,pair_3,LogGPT,1,success,1,8,135,0,144,11,114778,94847,209625,144
jan,pair_3,LogGPT,1,success,2,5,41,10,58,14,32779,26100,58879,58
vllm,pair_2,LogGPT,1,success,3,11,112,1,127,112,109763,86352,196115,127
retrofit,pair_1,LogGPT,2,success,1,3,16,2,22,0,12406,1020,13426,22
youtube-dl,pair_2,LogGPT,2,success,6,6,28,7,47,0,28389,2718,31107,47
meilisearch,pair_4,LogGPT,2,success,5,4,42,80,131,0,113489,4803,118292,131
generative-ai-for-beginners,pair_2,LogGPT,2,success,6,0,4,4,14,0,14001,800,14801,14
mongoose,pair_2,LogGPT,2,success,11,5,6,146,168,0,253251,6036,259287,168
code-server,pair_2,LogGPT,1,success,1,4,24,0,29,0,17214,13651,30865,29
bruno,pair_1,LogGPT,2,success,2,6,17,0,25,0,13185,1644,14829,25
ollama,pair_1,LogGPT,1,success,1,2,4,4,11,0,5882,4454,10336,11
supabase,pair_3,LogGPT,1,success,1,4,12,0,17,2,8347,6537,14884,17
gpt4all,pair_3,LogGPT,1,success,0,2,6,1,9,1,4835,3858,8693,9
cypress,pair_2,LogGPT,1,success,0,2,6,1,9,0,3595,2655,6250,9
django,pair_4,LogGPT,1,success,1,2,10,0,13,0,7826,6377,14203,13
spring-boot,pair_2,LogGPT,1,success,2,5,21,1,29,0,16594,12805,29399,29
hugo,pair_2,LogGPT,2,success,10,111,91,5,217,0,167122,11669,178791,217
slate,pair_1,LogGPT,2,success,6,6,79,52,143,0,91904,5369,97273,143
pandas,pair_2,LogGPT,1,success,6,3,45,5,59,3,45281,37765,83046,59
laravel,pair_2,LogGPT,2,success,2,3,20,0,25,0,19096,1135,20231,25
fabric,pair_1,LogGPT,2,success,15,1,3,97,116,0,148415,6322,154737,116
fabric,pair_4,LogGPT,2,success,1,6,41,0,48,0,34845,1821,36666,48
generative-ai-for-beginners,pair_4,LogGPT,1,success,3,3,1,0,7,8,4325,3745,8070,7
styled-components,pair_1,LogGPT,2,success,1,7,3,0,11,0,5176,892,6068,11
godot,pair_3,LogGPT,2,success,7,3,8,2,20,0,12646,1609,14255,20
ColossalAI,pair_1,LogGPT,1,success,2,5,20,1,28,0,14897,11752,26649,28
mongoose,pair_4,LogGPT,2,success,1,5,4,0,10,0,4392,1124,5516,10
spark,pair_1,LogGPT,1,success,1,2,1,0,4,0,1501,1059,2560,4
hugo,pair_2,LogGPT,1,success,6,121,73,8,208,9,151141,119241,270382,208
fuels-ts,pair_3,LogGPT,2,success,50,25,98,8,181,0,300750,11138,311888,181
vault,pair_2,LogGPT,1,success,1,2,1,0,4,0,1218,711,1929,4
netdata,pair_4,LogGPT,1,success,10,4,22,30,66,13,43456,33661,77117,66
htmx,pair_2,LogGPT,2,success,1,1,8,0,10,0,4302,458,4760,10
mongoose,pair_1,LogGPT,1,success,2,3,10,7,22,149,18247,7322,25569,22
PowerShell,pair_4,LogGPT,1,success,1,4,3,0,8,0,3196,2415,5611,8
bubbletea,pair_2,LogGPT,1,success,1,2,13,0,16,1,8258,6407,14665,16
gpt_academic,pair_1,LogGPT,2,success,12,8,25,12,57,0,95025,3753,98778,57
dify,pair_3,LogGPT,2,success,3,9,28,14,54,0,32904,2353,35257,54
retrofit,pair_4,LogGPT,2,success,17,4,17,351,389,0,269472,13375,282847,389
Ghost,pair_1,LogGPT,2,success,51,4,24,37,116,0,245355,9485,254840,116
ui,pair_2,LogGPT,2,success,7,1,4,90,102,0,127167,3555,130722,102
nvm,pair_1,LogGPT,1,success,1,2,4,0,7,1,3771,3115,6886,7
elasticsearch,pair_3,LogGPT,1,success,0,8,19,1,28,188,16543,9927,26470,28
stable-diffusion-webui,pair_4,LogGPT,2,success,1,1,8,0,10,0,3769,435,4204,10
vllm,pair_3,LogGPT,2,success,6,1,11,28,46,0,24184,1801,25985,46
markitdown,pair_2,LogGPT,2,success,8,3,6,1,18,0,11842,1640,13482,18
gpt_academic,pair_3,LogGPT,2,success,13,10,23,10,56,0,87058,3888,90946,56
spark,pair_2,LogGPT,2,success,1,1,2,0,4,0,1631,240,1871,4
retrofit,pair_4,LogGPT,1,success,8,3,16,360,387,2,266278,209348,475626,387
docling,pair_1,LogGPT,2,success,1,6,16,0,23,0,13351,1061,14412,23
insomnia,pair_1,LogGPT,1,success,3,27,32,1,63,24,49574,38504,88078,63
starship,pair_3,LogGPT,1,success,1,1,8,0,10,0,4383,3203,7586,10
ink-kit,pair_2,LogGPT,2,success,1,3,13,0,17,0,8109,1049,9158,17
ink-kit,pair_2,LogGPT,1,success,1,3,13,0,17,0,8035,6025,14060,17
uv,pair_1,LogGPT,2,success,22,4,23,63,112,0,265218,4836,270054,112
docling,pair_1,LogGPT,1,success,0,3,19,1,23,0,12868,10622,23490,23
dubbo,pair_1,LogGPT,2,success,27,5,10,277,319,0,255888,12833,268721,319
gpt_academic,pair_2,LogGPT,2,success,9,11,22,10,52,0,52878,3733,56611,52
bubbletea,pair_3,LogGPT,2,success,3,0,5,2,10,0,7490,617,8107,10
cpython,pair_2,LogGPT,1,success,2,5,5,8,20,0,10173,8277,18450,20
mongoose,pair_3,LogGPT,1,success,2,4,1,1,8,7,4380,3495,7875,8
duckdb,pair_1,LogGPT,1,success,89,11,219,731,1050,229,1039782,879058,1918840,1050
lossless-cut,pair_3,LogGPT,1,success,1,2,3,1,7,83,3855,1698,5553,7
retrofit,pair_1,LogGPT,1,success,2,3,14,1,20,2,9898,7517,17415,20
julia,pair_4,LogGPT,1,success,0,1,3,1,5,1,3169,2622,5791,5
lossless-cut,pair_4,LogGPT,1,success,1,3,2,1,7,83,3879,2268,6147,7
commander.js,pair_3,LogGPT,2,success,1,0,8,0,9,0,3744,713,4457,9
gpt_academic,pair_4,LogGPT,2,success,10,5,28,9,52,0,52665,3326,55991,52
generative-ai-for-beginners,pair_4,LogGPT,2,success,3,1,3,8,15,0,15980,961,16941,15
bruno,pair_1,LogGPT,1,success,2,5,18,0,25,0,13433,10840,24273,25
dify,pair_1,LogGPT,2,success,1,2,7,0,10,0,3695,476,4171,10
wtfpython,pair_2,LogGPT,1,success,1,3,4,0,8,0,3032,2498,5530,8
spring-boot,pair_3,LogGPT,2,success,13,5,8,22,48,0,37990,3082,41072,48
retrofit,pair_3,LogGPT,2,success,17,5,16,361,399,0,278207,14055,292262,399
stats,pair_4,LogGPT,1,success,1,6,15,0,22,0,9469,6824,16293,22
terminal,pair_2,LogGPT,1,success,1,1,1,0,3,0,918,775,1693,3
markitdown,pair_1,LogGPT,2,success,5,3,6,4,18,0,11320,1862,13182,18
cockroach,pair_2,LogGPT,1,success,2,2,8,8,20,1,10392,8167,18559,20
alpine,pair_1,LogGPT,2,success,1,1,4,9,15,0,15242,758,16000,15
flask,pair_4,LogGPT,2,success,25,3,11,137,176,3,137546,7097,144643,176
mongoose,pair_2,LogGPT,1,success,1,1,10,10,22,146,20636,7710,28346,22
pixijs,pair_2,LogGPT,2,success,1,2,5,0,8,0,22548,451,22999,8
LLMs-from-scratch,pair_1,LogGPT,2,success,1,6,12,0,19,0,8793,1071,9864,19
duckdb,pair_3,LogGPT,2,success,2,5,15,1,23,0,11761,1180,12941,23
netdata,pair_2,LogGPT,1,success,9,7,46,56,118,11,82271,67977,150248,118
dubbo,pair_1,LogGPT,1,success,7,4,11,291,313,6,244518,206290,450808,313
cpython,pair_4,LogGPT,1,success,0,14,418,2,434,26,397315,338570,735885,434
ionic-framework,pair_1,LogGPT,1,success,41,3,5,32,81,1,61484,53100,114584,81
meilisearch,pair_3,LogGPT,1,success,7,3,39,40,89,12,77034,65061,142095,89
ColossalAI,pair_4,LogGPT,1,success,5,7,39,4,55,18,43376,32589,75965,55
spring-boot,pair_1,LogGPT,1,success,2,5,21,1,29,0,16624,13223,29847,29
Ghost,pair_2,LogGPT,1,success,1,3,10,8,22,18,13985,11565,25550,22
cockroach,pair_1,LogGPT,1,success,1,2,17,3,23,5,13144,10557,23701,23
styled-components,pair_1,LogGPT,1,success,1,1,8,0,10,1,3882,2733,6615,10
LLMs-from-scratch,pair_4,LogGPT,1,success,1,3,15,0,19,0,9021,6576,15597,19
grafana,pair_4,LogGPT,1,success,248,4,6,5,263,63,250952,216615,467567,263
generative-ai-for-beginners,pair_2,LogGPT,1,success,2,2,2,0,6,8,2976,2119,5095,6
spark,pair_3,LogGPT,2,success,1,0,3,0,4,0,1592,179,1771,4
gpt_academic,pair_4,LogGPT,1,success,5,5,28,7,45,7,29606,19223,48829,45
AdminLTE,pair_2,LogGPT,2,success,5,4,6,0,15,0,8980,1473,10453,15
fabric,pair_3,LogGPT,1,success,1,4,6,0,11,0,5827,4338,10165,11
stable-diffusion-webui,pair_2,LogGPT,1,success,1,2,7,0,10,0,3552,2378,5930,10
certbot,pair_3,LogGPT,2,success,1,1,6,0,8,0,3880,411,4291,8
flask,pair_3,LogGPT,2,success,98,5,9,194,306,3,626794,14985,641779,306
duckdb,pair_3,LogGPT,1,success,2,2,18,1,23,0,11603,9110,20713,23
nvm,pair_2,LogGPT,1,success,3,3,10,0,16,1,9586,7651,17237,16
cockroach,pair_2,LogGPT,2,success,6,4,6,5,21,0,11697,1512,13209,21
meilisearch,pair_1,LogGPT,2,success,1,6,15,0,22,0,9945,1003,10948,22
supabase,pair_4,LogGPT,2,success,1,3,36,2,42,0,32734,2154,34888,42
laravel,pair_1,LogGPT,2,success,2,3,20,0,25,0,19223,1084,20307,25
hugo,pair_3,LogGPT,1,success,5,4,78,19,106,2,78030,63503,141533,106
terminal,pair_3,LogGPT,2,success,1,0,2,0,3,0,941,141,1082,3
grafana,pair_3,LogGPT,2,success,9,7,6,0,22,0,25488,2466,27954,22
nvm,pair_3,LogGPT,1,success,1,2,4,0,7,1,3668,3180,6848,7
tailwindcss,pair_1,LogGPT,1,success,1,3,31,17,52,5,36288,29211,65499,52
AutoGPT,pair_1,LogGPT,1,success,5,2,7,2,16,6,516091,3898,519989,16
okhttp,pair_3,LogGPT,2,success,7,7,19,16,49,0,34698,2630,37328,49
nvm,pair_2,LogGPT,2,success,2,5,9,1,17,0,11156,1035,12191,17
stable-diffusion-webui,pair_1,LogGPT,1,success,0,3,6,1,10,0,3626,2650,6276,10
AutoGPT,pair_2,LogGPT,1,success,0,2,7,0,9,0,3812,2980,6792,9
supabase,pair_3,LogSage,default,success,1,0,0,0,1,0,16464,105,16569,1
stats,pair_3,LogSage,default,success,1,0,0,0,1,0,10316,106,10422,1
llama_index,pair_4,LogSage,default,success,1,0,0,0,1,0,16592,109,16701,1
gpt4all,pair_1,LogSage,default,success,1,0,0,0,1,0,12943,118,13061,1
stable-diffusion-webui,pair_4,LogSage,default,success,1,0,0,0,1,0,10014,139,10153,1
gpt_academic,pair_1,LogSage,default,success,1,0,0,0,1,0,4753,570,5323,1
spring-boot,pair_2,LogSage,default,success,1,0,0,0,1,0,14354,92,14446,1
nvm,pair_3,LogSage,default,success,1,0,0,0,1,0,9643,97,9740,1
uv,pair_2,LogSage,default,success,1,0,0,0,1,0,16574,198,16772,1
cypress,pair_4,LogSage,default,success,1,0,0,0,1,0,8709,90,8799,1
wtfpython,pair_1,LogSage,default,success,1,0,0,0,1,0,24397,135,24532,1
vllm,pair_2,LogSage,default,success,1,0,0,0,1,0,15962,376,16338,1
spark,pair_3,LogSage,default,success,1,0,0,0,1,0,5174,110,5284,1
bruno,pair_1,LogSage,default,success,1,0,0,0,1,0,23013,134,23147,1
markitdown,pair_1,LogSage,default,success,1,0,0,0,1,0,21664,203,21867,1
AdminLTE,pair_1,LogSage,default,success,1,0,0,0,1,0,24445,200,24645,1
django,pair_1,LogSage,default,success,1,0,0,0,1,0,19205,487,19692,1
llama_index,pair_2,LogSage,default,success,1,0,0,0,1,0,23154,142,23296,1
meilisearch,pair_4,LogSage,default,success,1,0,0,0,1,0,7704,269,7973,1
duckdb,pair_4,LogSage,default,success,0,1,0,0,1,0,23110,112,23222,1
pandas,pair_2,LogSage,default,success,1,0,0,0,1,0,3392,287,3679,1
wtfpython,pair_4,LogSage,default,success,1,0,0,0,1,0,8878,135,9013,1
dify,pair_3,LogSage,default,success,0,1,0,0,1,0,4646,355,5001,1
open-webui,pair_1,LogSage,default,success,1,0,0,0,1,0,12501,106,12607,1
code-server,pair_2,LogSage,default,success,1,0,0,0,1,0,24410,151,24561,1
cpython,pair_1,LogSage,default,success,1,0,0,0,1,0,24557,474,25031,1
spring-boot,pair_1,LogSage,default,success,1,0,0,0,1,0,14348,92,14440,1
flask,pair_2,LogSage,default,success,1,0,0,0,1,0,23482,121,23603,1
hugo,pair_2,LogSage,default,success,1,0,0,0,1,0,4873,188,5061,1
spark,pair_4,LogSage,default,success,1,0,0,0,1,0,5180,115,5295,1
duckdb,pair_2,LogSage,default,success,1,0,0,0,1,0,24225,141,24366,1
gpt_academic,pair_2,LogSage,default,success,1,0,0,0,1,0,4652,170,4822,1
dubbo,pair_1,LogSage,default,success,1,0,0,0,1,0,16270,137,16407,1
laravel,pair_1,LogSage,default,success,1,0,0,0,1,0,21502,88,21590,1
ColossalAI,pair_1,LogSage,default,success,1,0,0,0,1,0,15442,133,15575,1
supabase,pair_4,LogSage,default,success,1,0,0,0,1,0,24454,119,24573,1
jan,pair_3,LogSage,default,success,1,0,0,0,1,0,6281,147,6428,1
playwright,pair_1,LogSage,default,success,1,0,0,0,1,0,15524,196,15720,1
nvm,pair_1,LogSage,default,success,1,0,0,0,1,0,9720,86,9806,1
PowerShell,pair_3,LogSage,default,success,1,0,0,0,1,0,12062,152,12214,1
laravel,pair_4,LogSage,default,success,1,0,0,0,1,0,21505,83,21588,1
certbot,pair_2,LogSage,default,success,1,0,0,0,1,0,4221,108,4329,1
slate,pair_4,LogSage,default,success,1,0,0,0,1,0,17755,99,17854,1
mongoose,pair_4,LogSage,default,success,1,0,0,0,1,0,10633,203,10836,1
stats,pair_1,LogSage,default,success,1,0,0,0,1,0,10944,167,11111,1
dify,pair_4,LogSage,default,success,1,0,0,0,1,0,22823,120,22943,1
code-server,pair_3,LogSage,default,success,1,0,0,0,1,0,24413,146,24559,1
cypress,pair_2,LogSage,default,success,1,0,0,0,1,0,8701,90,8791,1
ColossalAI,pair_2,LogSage,default,success,1,0,0,0,1,0,24527,795,25322,1
dubbo,pair_3,LogSage,default,success,1,0,0,0,1,0,25294,154,25448,1
n8n,pair_4,LogSage,default,success,1,0,0,0,1,0,24425,240,24665,1
lossless-cut,pair_3,LogSage,default,success,1,0,0,0,1,0,21166,159,21325,1
flask,pair_1,LogSage,default,success,1,0,0,0,1,0,19268,129,19397,1
prettier,pair_4,LogSage,default,success,1,0,0,0,1,0,24390,123,24513,1
flask,pair_3,LogSage,default,success,1,0,0,0,1,0,4787,154,4941,1
prettier,pair_2,LogSage,default,success,1,0,0,0,1,0,13098,95,13193,1
stats,pair_4,LogSage,default,success,1,0,0,0,1,0,10304,134,10438,1
fabric,pair_4,LogSage,default,success,1,0,0,0,1,0,24325,119,24444,1
styled-components,pair_1,LogSage,default,success,1,0,0,0,1,0,11623,109,11732,1
certbot,pair_3,LogSage,default,success,1,0,0,0,1,0,9649,103,9752,1
certbot,pair_4,LogSage,default,success,1,0,0,0,1,0,9642,147,9789,1
wtfpython,pair_3,LogSage,default,success,1,0,0,0,1,0,8873,153,9026,1
open-webui,pair_3,LogSage,default,success,1,0,0,0,1,0,10823,187,11010,1
insomnia,pair_1,LogSage,default,success,1,0,0,0,1,0,7524,227,7751,1
bubbletea,pair_3,LogSage,default,success,1,0,0,0,1,0,10379,122,10501,1
netdata,pair_4,LogSage,default,success,1,0,0,0,1,0,17578,102,17680,1
vllm,pair_4,LogSage,default,success,1,0,0,0,1,0,10247,360,10607,1
django,pair_4,LogSage,default,success,1,0,0,0,1,0,15532,109,15641,1
julia,pair_3,LogSage,default,success,1,0,0,0,1,0,11308,91,11399,1
okhttp,pair_3,LogSage,default,success,1,0,0,0,1,0,24347,132,24479,1
cockroach,pair_2,LogSage,default,success,1,0,0,0,1,0,21292,226,21518,1
supabase,pair_1,LogSage,default,success,1,0,0,0,1,0,16444,129,16573,1
godot,pair_2,LogSage,default,success,1,0,0,0,1,0,18759,94,18853,1
terminal,pair_4,LogSage,default,success,1,0,0,0,1,0,3886,89,3975,1
grafana,pair_3,LogSage,default,success,1,0,0,0,1,0,24369,689,25058,1
hugo,pair_1,LogSage,default,success,1,0,0,0,1,0,4882,255,5137,1
llama_index,pair_3,LogSage,default,success,1,0,0,0,1,0,23650,156,23806,1
open-webui,pair_2,LogSage,default,success,1,0,0,0,1,0,11854,120,11974,1
meilisearch,pair_1,LogSage,default,success,1,0,0,0,1,0,11372,102,11474,1
spring-boot,pair_3,LogSage,default,success,1,0,0,0,1,0,24575,374,24949,1
ionic-framework,pair_2,LogSage,default,success,1,0,0,0,1,0,3643,199,3842,1
fabric,pair_3,LogSage,default,success,1,0,0,0,1,0,8093,91,8184,1
markitdown,pair_2,LogSage,default,success,1,0,0,0,1,0,21795,292,22087,1
lossless-cut,pair_2,LogSage,default,success,1,0,0,0,1,0,18519,224,18743,1
youtube-dl,pair_2,LogSage,default,success,1,0,0,0,1,0,24559,189,24748,1
nvm,pair_4,LogSage,default,success,1,0,0,0,1,0,20023,103,20126,1
generative-ai-for-beginners,pair_1,LogSage,default,success,1,0,0,0,1,0,19830,163,19993,1
fabric,pair_2,LogSage,default,success,1,0,0,0,1,0,24499,90,24589,1
hugo,pair_3,LogSage,default,success,1,0,0,0,1,0,9683,268,9951,1
markitdown,pair_3,LogSage,default,success,1,0,0,0,1,0,11842,154,11996,1
meilisearch,pair_2,LogSage,default,success,1,0,0,0,1,0,11487,115,11602,1
gpt_academic,pair_3,LogSage,default,success,1,0,0,0,1,0,14835,255,15090,1
nvm,pair_2,LogSage,default,success,1,0,0,0,1,0,20105,108,20213,1
slate,pair_3,LogSage,default,success,1,0,0,0,1,0,18089,106,18195,1
pandas,pair_3,LogSage,default,success,1,0,0,0,1,0,17817,124,17941,1
mongoose,pair_1,LogSage,default,success,1,0,0,0,1,0,24370,149,24519,1
pandas,pair_4,LogSage,default,failed,0,0,0,0,0,0,0,0,0,0
godot,pair_1,LogSage,default,success,1,0,0,0,1,0,23185,175,23360,1
spark,pair_2,LogSage,default,success,1,0,0,0,1,0,5173,110,5283,1
grafana,pair_2,LogSage,default,success,1,0,0,0,1,0,24486,437,24923,1
RxJava,pair_1,LogSage,default,success,1,0,0,0,1,0,24334,134,24468,1
pixijs,pair_1,LogSage,default,success,1,0,0,0,1,0,15960,260,16220,1
n8n,pair_2,LogSage,default,success,1,0,0,0,1,0,13970,192,14162,1
PowerShell,pair_1,LogSage,default,success,1,0,0,0,1,0,12574,150,12724,1
django,pair_3,LogSage,default,success,1,0,0,0,1,0,11037,91,11128,1
gpt4all,pair_4,LogSage,default,success,1,0,0,0,1,0,12730,110,12840,1
lx-music-desktop,pair_1,LogSage,default,success,1,0,0,0,1,0,21650,113,21763,1
fuels-ts,pair_1,LogSage,default,success,1,0,0,0,1,0,11667,200,11867,1
duckdb,pair_1,LogSage,default,success,1,0,0,0,1,0,17354,258,17612,1
dify,pair_1,LogSage,default,success,1,0,0,0,1,0,9738,130,9868,1
htmx,pair_2,LogSage,default,success,1,0,0,0,1,0,10314,112,10426,1
ink-kit,pair_3,LogSage,default,success,1,0,0,0,1,0,11661,133,11794,1
tailwindcss,pair_1,LogSage,default,success,1,0,0,0,1,0,5485,172,5657,1
okhttp,pair_2,LogSage,default,success,1,0,0,0,1,0,9943,183,10126,1
mantine,pair_1,LogSage,default,success,1,0,0,0,1,0,24431,113,24544,1
slate,pair_1,LogSage,default,success,1,0,0,0,1,0,3933,86,4019,1
mongoose,pair_2,LogSage,default,success,1,0,0,0,1,0,24431,145,24576,1
dubbo,pair_4,LogSage,default,success,1,0,0,0,1,0,25451,129,25580,1
starship,pair_2,LogSage,default,success,1,0,0,0,1,0,10548,140,10688,1
grafana,pair_4,LogSage,default,success,1,0,0,0,1,0,24510,240,24750,1
PowerShell,pair_4,LogSage,default,success,1,0,0,0,1,0,8533,104,8637,1
mongoose,pair_3,LogSage,default,success,1,0,0,0,1,0,19208,165,19373,1
code-server,pair_1,LogSage,default,success,1,0,0,0,1,0,24404,124,24528,1
starship,pair_1,LogSage,default,success,1,0,0,0,1,0,10540,137,10677,1
ColossalAI,pair_4,LogSage,default,success,1,0,0,0,1,0,14961,104,15065,1
stats,pair_2,LogSage,default,success,1,0,0,0,1,0,10707,114,10821,1
uv,pair_3,LogSage,default,success,1,0,0,0,1,0,24447,185,24632,1
LLMs-from-scratch,pair_3,LogSage,default,success,1,0,0,0,1,0,22731,306,23037,1
AutoGPT,pair_3,LogSage,default,success,1,0,0,0,1,0,13358,97,13455,1
okhttp,pair_1,LogSage,default,success,1,0,0,0,1,0,10768,218,10986,1
retrofit,pair_1,LogSage,default,success,1,0,0,0,1,0,22803,198,23001,1
lossless-cut,pair_4,LogSage,default,success,1,0,0,0,1,0,21244,227,21471,1
n8n,pair_1,LogSage,default,success,1,0,0,0,1,0,24412,280,24692,1
cpython,pair_3,LogSage,default,success,1,0,0,0,1,0,22060,173,22233,1
pixijs,pair_2,LogSage,default,success,1,0,0,0,1,0,24869,63,24932,1
Ghost,pair_2,LogSage,default,success,1,0,0,0,1,0,6732,193,6925,1
generative-ai-for-beginners,pair_4,LogSage,default,success,1,0,0,0,1,0,17231,245,17476,1
ink-kit,pair_1,LogSage,default,success,1,0,0,0,1,0,16902,168,17070,1
jan,pair_1,LogSage,default,success,1,0,0,0,1,0,7809,153,7962,1
gpt4all,pair_3,LogSage,default,success,1,0,0,0,1,0,12916,122,13038,1
hugo,pair_4,LogSage,default,success,1,0,0,0,1,0,13041,419,13460,1
django,pair_2,LogSage,default,success,1,0,0,0,1,0,11752,125,11877,1
markitdown,pair_4,LogSage,default,success,1,0,0,0,1,0,24461,135,24596,1
AutoGPT,pair_4,LogSage,default,success,1,0,0,0,3,2,7644,323,7967,3
terraform,pair_2,LogSage,default,success,1,0,0,0,1,0,13834,99,13933,1
bubbletea,pair_2,LogSage,default,success,0,1,0,0,1,0,17519,205,17724,1
jan,pair_2,LogSage,default,success,1,0,0,0,1,0,7812,109,7921,1
insomnia,pair_3,LogSage,default,success,1,0,0,0,1,0,10525,127,10652,1
pixijs,pair_3,LogSage,default,success,1,0,0,0,1,0,11774,205,11979,1
ui,pair_1,LogSage,default,success,1,0,0,0,1,0,14513,118,14631,1
bubbletea,pair_4,LogSage,default,success,1,0,0,0,1,0,13881,167,14048,1
vault,pair_1,LogSage,default,success,1,0,0,0,1,0,13109,93,13202,1
laravel,pair_3,LogSage,default,success,1,0,0,0,1,0,21506,100,21606,1
gpt4all,pair_2,LogSage,default,success,1,0,0,0,1,0,12589,134,12723,1
insomnia,pair_2,LogSage,default,success,1,0,0,0,1,0,24448,193,24641,1
playwright,pair_2,LogSage,default,success,1,0,0,0,1,0,3059,119,3178,1
youtube-dl,pair_1,LogSage,default,success,1,0,0,0,1,0,13124,131,13255,1
LLMs-from-scratch,pair_1,LogSage,default,success,1,0,0,0,1,0,20695,112,20807,1
starship,pair_3,LogSage,default,success,1,0,0,0,1,0,10532,125,10657,1
vault,pair_2,LogSage,default,success,1,0,0,0,1,0,4084,89,4173,1
commander.js,pair_3,LogSage,default,success,1,0,0,0,1,0,9351,149,9500,1
elasticsearch,pair_3,LogSage,default,success,1,0,0,0,1,0,24465,82,24547,1
elasticsearch,pair_1,LogSage,default,success,1,0,0,0,1,0,9149,132,9281,1
pixijs,pair_4,LogSage,default,success,1,0,0,0,1,0,11540,284,11824,1
dubbo,pair_2,LogSage,default,success,1,0,0,0,1,0,25446,159,25605,1
vllm,pair_1,LogSage,default,success,1,0,0,0,1,0,2542,84,2626,1
stable-diffusion-webui,pair_1,LogSage,default,success,1,0,0,0,1,0,9448,162,9610,1
alpine,pair_2,LogSage,default,success,1,0,0,0,1,0,11318,109,11427,1
flask,pair_4,LogSage,default,success,1,0,0,0,1,0,24490,161,24651,1
retrofit,pair_2,LogSage,default,success,1,0,0,0,1,0,24345,153,24498,1
fabric,pair_1,LogSage,default,success,1,0,0,0,1,0,14845,96,14941,1
vault,pair_3,LogSage,default,success,1,0,0,0,1,0,4085,89,4174,1
julia,pair_2,LogSage,default,success,1,0,0,0,1,0,8785,119,8904,1
gpt_academic,pair_4,LogSage,default,success,1,0,0,0,1,0,4655,302,4957,1
llama_index,pair_1,LogSage,default,success,1,0,0,0,1,0,16752,108,16860,1
ui,pair_2,LogSage,default,success,1,0,0,0,1,0,15938,224,16162,1
docling,pair_1,LogSage,default,success,1,0,0,0,1,0,19064,86,19150,1
julia,pair_4,LogSage,default,success,1,0,0,0,1,0,8232,100,8332,1
AutoGPT,pair_1,LogSage,default,success,1,0,0,0,1,0,2549,75,2624,1
playwright,pair_4,LogSage,default,success,1,0,0,0,1,0,23296,128,23424,1
terraform,pair_3,LogSage,default,success,1,0,0,0,1,0,11379,157,11536,1
AutoGPT,pair_2,LogSage,default,success,1,0,0,0,1,1,11010,289,11299,1
ionic-framework,pair_3,LogSage,default,success,1,0,0,0,1,0,23104,153,23257,1
prettier,pair_3,LogSage,default,success,1,0,0,0,1,0,24744,374,25118,1
certbot,pair_1,LogSage,default,success,1,0,0,0,1,0,4222,110,4332,1
terminal,pair_1,LogSage,default,success,1,0,0,0,1,0,3886,90,3976,1
uv,pair_1,LogSage,default,success,1,0,0,0,1,0,15716,238,15954,1
netdata,pair_3,LogSage,default,success,1,0,0,0,1,0,24320,215,24535,1
pandas,pair_1,LogSage,default,success,1,0,0,0,1,0,12696,266,12962,1
alpine,pair_1,LogSage,default,success,1,0,0,0,1,0,18359,147,18506,1
elasticsearch,pair_2,LogSage,default,success,1,0,0,0,1,0,10127,108,10235,1
terraform,pair_1,LogSage,default,success,1,0,0,0,1,0,16989,181,17170,1
netdata,pair_2,LogSage,default,success,1,0,0,0,1,0,15538,158,15696,1
neovim,pair_1,LogSage,default,success,1,0,0,0,1,0,9131,157,9288,1
stable-diffusion-webui,pair_2,LogSage,default,success,1,0,0,0,1,0,9450,151,9601,1
cypress,pair_1,LogSage,default,success,1,0,0,0,1,0,8709,90,8799,1
starship,pair_4,LogSage,default,success,1,0,0,0,1,0,10530,134,10664,1
commander.js,pair_4,LogSage,default,success,1,0,0,0,1,0,9872,136,10008,1
prettier,pair_1,LogSage,default,success,1,0,0,0,1,0,12188,135,12323,1
cockroach,pair_3,LogSage,default,success,1,0,0,0,1,0,5572,127,5699,1
commander.js,pair_2,LogSage,default,success,1,0,0,0,1,0,9849,116,9965,1
supabase,pair_2,LogSage,default,success,1,0,0,0,1,0,24426,107,24533,1
ionic-framework,pair_1,LogSage,default,success,1,0,0,0,1,0,24404,348,24752,1
spring-boot,pair_4,LogSage,default,success,1,0,0,0,1,0,14295,102,14397,1
Ghost,pair_1,LogSage,default,success,1,0,0,0,1,0,24110,361,24471,1
terminal,pair_3,LogSage,default,success,1,0,0,0,1,0,3886,89,3975,1
retrofit,pair_4,LogSage,default,success,1,0,0,0,1,0,24410,122,24532,1
n8n,pair_3,LogSage,default,success,1,0,0,0,1,0,20496,184,20680,1
julia,pair_1,LogSage,default,success,1,0,0,0,1,0,11330,79,11409,1
LLMs-from-scratch,pair_4,LogSage,default,success,1,0,0,0,1,0,20686,114,20800,1
duckdb,pair_3,LogSage,default,success,1,0,0,0,1,0,20687,253,20940,1
ollama,pair_1,LogSage,default,success,1,0,0,0,1,0,13923,101,14024,1
fuels-ts,pair_3,LogSage,default,success,1,0,0,0,1,0,24169,300,24469,1
stable-diffusion-webui,pair_3,LogSage,default,success,1,0,0,0,1,0,9441,145,9586,1
jan,pair_4,LogSage,default,success,1,0,0,0,1,0,24311,120,24431,1
retrofit,pair_3,LogSage,default,success,1,0,0,0,1,0,11725,178,11903,1
generative-ai-for-beginners,pair_3,LogSage,default,success,1,0,0,0,1,0,18911,207,19118,1
ink-kit,pair_2,LogSage,default,success,1,0,0,0,2,1,34282,393,34675,2
terminal,pair_2,LogSage,default,success,1,0,0,0,1,0,3886,89,3975,1
htmx,pair_1,LogSage,default,success,1,0,0,0,1,0,17258,138,17396,1
fuels-ts,pair_2,LogSage,default,success,1,0,0,0,1,0,23678,101,23779,1
ionic-framework,pair_4,LogSage,default,success,1,0,0,0,1,0,17739,121,17860,1
dify,pair_2,LogSage,default,success,1,0,0,0,1,0,5574,259,5833,1
cypress,pair_3,LogSage,default,success,1,0,0,0,1,0,8710,93,8803,1
laravel,pair_2,LogSage,default,success,1,0,0,0,1,0,21504,92,21596,1
generative-ai-for-beginners,pair_2,LogSage,default,success,1,0,0,0,1,0,19915,161,20076,1
AdminLTE,pair_2,LogSage,default,success,1,0,0,0,1,0,14869,133,15002,1
bubbletea,pair_1,LogSage,default,success,0,1,0,0,1,0,17992,190,18182,1
cockroach,pair_1,LogSage,default,success,1,0,0,0,1,0,24310,104,24414,1
grafana,pair_1,LogSage,default,success,0,1,0,0,1,0,18384,193,18577,1
LLMs-from-scratch,pair_2,LogSage,default,success,1,0,0,0,1,0,22423,240,22663,1
commander.js,pair_1,LogSage,default,success,1,0,0,0,1,0,15597,96,15693,1
tailwindcss,pair_2,LogSage,default,success,1,0,0,0,1,0,5311,191,5502,1
wtfpython,pair_2,LogSage,default,success,1,0,0,0,1,0,8764,122,8886,1
cpython,pair_4,LogSage,default,success,1,0,0,0,1,0,24417,146,24563,1
godot,pair_4,LogSage,default,success,1,0,0,0,1,0,18873,93,18966,1
netdata,pair_1,LogSage,default,success,1,0,0,0,1,0,15528,166,15694,1
fzf,pair_1,LogSage,default,success,1,0,0,0,1,0,17983,147,18130,1
slate,pair_2,LogSage,default,success,1,0,0,0,1,0,17328,99,17427,1
godot,pair_3,LogSage,default,success,1,0,0,0,1,0,23328,236,23564,1
open-webui,pair_4,LogSage,default,success,1,0,0,0,1,0,11029,185,11214,1
lossless-cut,pair_1,LogSage,default,success,1,0,0,0,1,0,19824,151,19975,1
vllm,pair_3,LogSage,default,success,1,0,0,0,1,0,2548,91,2639,1
meilisearch,pair_3,LogSage,default,success,1,0,0,0,1,0,15331,233,15564,1
ColossalAI,pair_3,LogSage,default,success,1,0,0,0,1,0,24527,731,25258,1
cpython,pair_2,LogSage,default,success,1,0,0,0,1,0,22293,303,22596,1
playwright,pair_3,LogSage,default,success,1,0,0,0,1,0,24415,84,24499,1
elasticsearch,pair_4,LogSage,default,failed,0,0,0,0,0,0,0,0,0,0
spark,pair_1,LogSage,default,success,1,0,0,0,1,0,5173,124,5297,1
PowerShell,pair_2,LogSage,default,success,1,0,0,0,1,0,12348,183,12531,1
